㐀	丘
㐅	五
㐊	㐋
㐋	㐊
㐫	凶
㐮	襄
㐯	庸
㐱	鬒
㐴	攀
㐵	儒
㐷	傌
㐹	㑶
㐽	偑
㑁	𠭴
㑄	侮
㑇	㑳
㑈	倲
㑌	尩
㑔	㑯
㑝	𢙱
㑩	儸
㑮	𫝈
㑯	㑔
㑳	㑇
㑶	㐹
㑺	儁
㒇	儛
㒋	廝 厮
㒓	𠉂
㒚	穩 文
㒜	𠇐
㒞	儶
㒣	𬾖
㒰	全
㒲	財
㒷	興
㒿	𰖩
㓁	网
㓄	𪠟
㓓	湳
㓕	滅
㓖	滭 𰃻
㓗	潔
㓟	披
㓥	劏
㓨	刾
㓮	雕 彫
㓷	劓
㓸	斲
㔃	𫦌
㔅	𫦅
㔉	劚
㔋	𪟎
㔍	䥷
㔝	𫦩
㔢	𫦳
㔱	斞
㔾	卩
㕑	𢊍 厨
㕒	𰆕
㕚	爪 爫
㕞	刷
㕢	𰇀
㖈	䎛
㖊	噚
㖞	喎
㖦	𰇎
㖮	𪠵
㗖	啗 啖 噉
㗙	𫩩
㗢	𰇖
㗣	𫪺
㗰	𫩛
㗲	𠵾
㗳	嗒
㗶	𭇜
㗻	𫪀
㗼	𫩤
㗿	𪡛
㘅	銜 啣
㘎	㘚
㘓	𪢌
㘔	𫬐
㘖	𰉁
㘙	𫪂
㘚	㘎
㘤	𡈛
㘽	㦳
㙔	𰉘
㙡	𭎂
㙢	𰊟
㙬	𫮜
㙮	塔
㙳	轗
㙺	𰊛
㙾	𰉽
㚝	奞 奎
㚣	姣
㚯	㜄
㛀	媰
㛛	娠
㛝	𫝦
㛟	𡞵
㛠	𡢃
㛣	㜏
㛤	孋
㛿	𡠹
㜄	㚯
㜏	㛣
㜐	𫝧
㜗	𡞋
㜞	𰌆
㜢	𡞱
㜥	𫰨
㜭	𫰠
㜮	𫱕
㜷	𡝠
㜺	𫲗
㝃	娩
㝛	宿
㝞	𫳃
㝟	𫤸
㝦	寯
㝵	礙 碍
㞐	居
㞞	𪨊
㟆	㠏
㟗	豳 邠
㟜	𡾱
㟥	嵾
㟺	𪩇
㠁	𫶅
㠊	嶇
㠏	㟆
㠠	𰎐
㠣	𫵷
㠯	以
㠶	帆
㡎	幓
㡓	𫷅
㡘	𢅏
㡞	𰏜
㡿	斥
㢗	𪪑
㢝	𢋈
㣶	邅
㣺	心
㣼	忍
㤒	笨
㤖	懧
㤘	㥮
㤭	憍
㤲	𫺁
㤵	慈
㤽	懤
㥃	悶 懣
㥪	慺
㥮	㤘
㥵	慁
㥷	𰑸
㦈	𢣏
㦊	𫺆
㦎	𢛯
㦖	𫺓
㦛	𢗓
㦞	𪫷
㦦	𫻁
㦧	憯
㦬	𰑫
㦭	𭝋
㦳	㘽
㧃	收
㧏	掆
㧐	㩳
㧑	撝
㧖	扼 搤
㧛	擥
㧜	擸
㧟	擓
㧰	擽
㨉	抿
㨗	捷
㨛	𰓔
㨟	𫼥
㨥	𫽀
㨨	㩅
㨫	㩜
㨻	𪮃
㨼	撂
㩁	搉
㩅	㨨
㩇	𫽇
㩋	𪮋
㩌	𫽧
㩜	攬 㨫 擥
㩣	𫾉
㩭	𫽊
㩳	㧐
㩵	擜
㩷	𰔲
㩹	𢶣
㪅	更
㪎	𪯋
㪯	舉
㪹	𬖠
㫃	偃
㫎	幑 𣄈
㫚	昒 曶
㬅	曼
㬣	𬀮
㬮	𰖠
㬱	朁
㬵	胶
㬹	踭
㬺	幐
㬻	䐠
㭎	棡
㭏	椲
㭑	枺
㭣	𣙎
㭤	樢
㭨	椰
㭴	樫
㮓	𣕲
㮝	𣒗
㮠	𣞁
㮣	槪 槩
㮲	𰗙
㯂	𰘀
㯃	桼 漆
㯆	𰗡
㯤	𣘐
㯭	櫓 樐
㯶	棕
㯸	𰗦
㯼	𣙥
㯽	檳
㰂	𰗵
㰅	𭫙
㰍	𬺜 櫳
㰰	𬅢
㰳	𭭈
㱩	殰
㱮	殨
㱿	壳 殼
㲒	勽
㲓	毧
㲯	𰚪
㲰	𰚔
㲲	𬇇
㲿	瀇
㳄	涎
㳔	濧
㳕	灡
㳠	澾
㳡	濄
㳢	𣾷
㳽	瀰
㴋	潚
㴑	溯
㴔	潝
㴸	𰛛
㴿	𰛽
㵍	𬇰
㵑	𰜢
㵒	沸 𬈕
㵗	𣳆
㵤	𬉇
㵾	𪷍
㶆	𫞛
㶉	鸂
㶌	𣾍
㶍	𰝟
㶏	𰝋
㶒	𰛩
㶕	𰝗
㶶	燶
㶽	煱
㷃	𰝾
㷉	熨
㷍	𤆢
㷠	燐 粦
㷪	𤎱
㷲	𰞉
㷶	𰞲
㷻	𭴊 煳
㷿	𤈷
㸅	𰞍
㸊	𬋍
㸐	𬊾
㹓	𰠴
㹽	𫞣
㺍	獱
㺏	𤠋
㺑	𬌷
㺜	𪺻
㻅	璯
㻏	𤫩
㻘	𤪺
㻪	㻽
㻶	𪼋
㻽	㻪
㼆	𬎆
㼈	𭹜
㼻	𬎧
㽣	域
㽽	痼
㾙	脪
㾡	𤷽
㾵	𬏟
㾺	𬏜
㿉	𰣶
㿎	𬏷
㿖	𪽮
㿗	𤻊
㿟	皎 皦
㿧	𤽯
㿷	糙
㿹	𰤨
䀉	𥁢
䀋	鹽
䀍	𰥊
䀠	瞿
䀢	瞬
䀥	䁻
䀴	𬑏
䀹	睫 𥅴 鿃
䀿	晣
䁖	瞜
䁝	𰥞
䁪	𥇢
䁱	𬑒
䁻	䀥
䂀	𥋟
䂎	𥎝
䂓	𰦔
䂫	夯
䂵	碽
䃁	𰦴
䃅	磾
䃉	珉
䃕	𰦷
䃘	𬒎 硜
䃢	𰧎
䃣	𰦨
䃤	𬒕
䃮	鿎
䃴	𰧘
䄃	殃
䄍	蜡
䄯	𢆞
䄺	稊
䅉	稏
䅐	𫀨
䅘	𥟂
䅟	穇
䅪	𥢢
䅳	𫀬
䆅	𰨳
䆉	𫁂
䆋	秋
䆔	竉
䆫	窓 窗
䇓	𰩧
䇚	𥵜
䇲	筴
䈇	罩
䉍	𬕊
䉐	𬕛
䉑	𫁲
䉙	𥬀
䉤	籔
䉬	𫂈
䉱	𬕦
䉲	𥮜
䉵	籑 饌
䉶	𫁷
䊜	𰪫 糰
䊟	𰫋
䊭	𥺅
䊲	𬡻
䊵	𮉠
䊷	䌶
䊺	𫄚
䋃	𫄜
䋆	𰬁
䋍	𰬂
䋎	𬘜
䋏	𮉣
䋐	𬘙
䋑	𰬃
䋔	𫄞
䋙	䌺
䋚	䌻
䋦	𫄩
䋫	𰬑
䋲	繩
䋹	䌿
䋺	𬘴
䋻	䌾
䋼	𫄮
䋽	𰬭
䋾	𬘲
䋿	𦈓
䌁	𬘱
䌇	𰬱
䌈	𦈖
䌋	𦈘
䌌	𰬶
䌐	𬘮
䌖	𦈜
䌝	𦈟
䌞	𬘪
䌟	𦈞
䌥	縯 𦈠
䌪	𬙁
䌫	纜
䌰	𦈙
䌶	䊷
䌷	紬
䌸	縳
䌹	絅
䌺	䋙
䌻	䋚
䌼	綐
䌽	綵
䌾	䋻
䌿	䋹
䍀	繿
䍁	繸
䍤	𫅅
䍷	𬙭
䍽	𦍠
䎘	𬚄
䎙	𫅭
䎛	㖈
䎬	䎱
䎱	䎬
䏊	𰭹
䏓	朊
䏕	飪
䏝	膞
䐠	㬻
䐢	𰮙
䐣	𬁽
䐪	臇
䐰	饈
䐷	𬂅
䐹	𰮲
䐽	𰯎
䑃	朦
䑗	𬛹
䑼	𰰌
䒒	苕
䓓	薵
䓕	薳
䓣	𬜯
䔇	𰰴
䔈	𰱀
䔛	檾
䔡	𬝁
䕌	稚
䕡	𰱩
䕤	𫟕
䕳	𦰴
䕹	𰰶
䕼	𬝴
䖀	𰲖
䖅	𫟑
䖈	虐
䖍	虔
䖏	処 處
䖚	𰲟
䖟	蝱
䖣	蚤
䖵	蜫
䖼	𧍕
䗃	𰲳
䗅	𫊪
䗖	螮
䗥	𰲯
䗻	𮔂
䗽	𰳚
䗿	𧉞
䘑	脉
䘚	卒
䘛	𧝞
䘞	𧜗
䘺	綻
䙊	𧜵
䙌	䙡
䙓	襬
䙔	𫋲
䙝	褺 褻
䙡	䙌
䙱	𧜭
䙼	𰴖
䚆	𬢑
䚉	𬢐
䚎	𥅾
䚕	𰴗
䚞	𰴤
䚩	𫌯
䚳	𬣛
䚵	𬣟
䚶	訞
䚽	𬣜
䛀	𰵐
䛄	𫍠
䛌	𰵜
䛍	𬣧
䛓	譼
䛘	𬣯
䛛	𬣬
䛞	𬣸
䛠	𰵫
䛡	話
䛤	𬣹
䛬	𬤁
䛭	𰵰
䛳	𫍫
䛻	誘
䛼	譭
䛽	𬤌
䛿	𬤑
䜀	䜧
䜄	𰶈
䜉	𬤘
䜊	嘈
䜋	𬤉
䜍	𬤟
䜎	𬣿
䜏	𰶇
䜒	𬤡
䜖	𫟢
䜚	𬤪
䜝	𬤬
䜣	訢
䜤	鿁
䜥	𧩙
䜧	䜀
䜩	讌
䜶	豇
䝋	豵
䝏	𰶬
䝕	𬥄
䝙	貙
䝜	狻
䝤	獠
䝭	𫎧
䝯	𬥵
䝻	𧹕
䝼	䞍
䞀	𬥽
䞁	𬥺
䞂	𬥻
䞈	𧹑
䞉	𰷩
䞋	𫎪
䞌	𧵳
䞍	䝼
䞎	𧶧
䞐	賰
䞓	𫎭 赬
䞶	𬦅
䟃	𫎺
䟆	𫎳
䟏	𰷴
䟐	𫎱
䟢	躎
䟺	𬦥
䠆	𫏃
䠟	𰸈
䠠	𰸛
䠩	𰸊
䠮	𬧃
䠱	躅 𨅛
䡁	𬧢
䡅	𰹳
䡇	𰹷
䡊	𰹺
䡐	𫟤
䡗	𬨆
䡘	𬨉
䡝	𰺑
䡟	𬨌
䡦	𬨑
䡩	𫟥
䡰	𰺘
䡴	𰺝
䡵	𫟦
䡶	𬨔
䡷	𰺡
䡻	𰺤
䡾	𰺠
䢀	𨊰
䢁	𨊸
䢂	𨋢
䢈	𰺭
䢙	敗
䢨	𨑹
䣩	醇
䤌	𮠞
䤍	𨢥 𰼑
䤠	𰽠
䤤	𫟺
䤥	𰽺
䤨	𰽸
䤩	𬭈
䤪	𬭆
䤬	𰾈
䤵	𰾐
䤸	𰾦
䤻	𰾖
䤼	𬭣
䥀	捵
䥄	𫠀
䥇	䦂
䥑	鿏
䥕	𬭯
䥖	𰾻
䥗	𫔋
䥛	𬭴
䥝	𰿁
䥞	𬭻
䥨	鑢
䥩	𨱖
䥯	𫔆
䥱	䥾
䥴	𰿅
䥶	𰽝
䥷	𰿇 㔍
䥸	𨧮
䥺	釾
䥽	鏺
䥾	䥱
䥿	𨯅
䦀	𨦫
䦁	𨧜
䦂	䥇
䦃	鐯
䦅	鐥
䦆	钁
䦌	𮤬
䦎	𰿨
䦓	𦕒 覘
䦘	𨸄
䦛	䦶
䦝	𬮨
䦟	䦷
䦪	𰿴
䦯	𫔵
䦱	𰿫
䦳	𨷿
䦶	䦛
䦷	䦟
䧞	𬮺
䧢	𨸟
䨘	霰
䨴	𱁒
䩄	靦
䩞	韂
䩫	𬰥
䪊	𫖅 龓
䪍	𱁽
䪏	𩏼
䪐	𱂅
䪓	𬰳
䪗	𩐀
䪘	𩏿
䪜	𬰷
䪝	𱂌
䪥	𱂎
䪴	𫖫
䪼	𱂢
䪾	𫖬
䪿	囟
䫀	𫖱
䫂	𫖰
䫈	𬱣
䫉	𬥈
䫌	𱂮
䫏	𬱦
䫐	𬃲
䫜	𬱮
䫟	𫖲
䫠	𬱰
䫥	𱆚
䫩	𬱬
䫴	𩖗
䫶	𫖺
䫻	𫗇
䫼	𬱷
䫾	𫠈
䬀	𱃖
䬂	𬱸
䬅	𱃚
䬍	𬲀
䬎	𬱿
䬐	𱃜
䬒	颼
䬓	𫗊
䬔	𱃞
䬘	𩙮
䬝	𩙯
䬞	𩙧
䬟	𱃙
䬡	翥
䬣	𱃱
䬧	𫗟
䬪	𱃳
䬫	𬲮
䬬	𱃵
䬯	𬲫
䬲	𬲯
䬳	𱃷
䬶	𬲷
䬹	𱃸
䬾	𬲻
䭀	𩠇
䭃	𩠈
䭅	𬲾
䭇	𬳀
䭈	𱄃
䭉	𬳅
䭑	𫗱
䭒	𬳋
䭓	𱃹
䭔	𫗰
䭕	𬲕
䭘	𬳑
䭞	𬲳
䭡	𱄉
䭢	𬲲
䭣	𬲶
䭪	𩞯
䭭	𬱯
䭾	馱
䭿	𩧭
䮂	𱅄
䮄	𫠊
䮈	𬳾
䮗	𬴁
䮝	𩧰
䮞	𩨁
䮠	𩧿
䮧	𱅠
䮫	𩨇
䮰	𫘮
䮲	𱅦
䮳	𩨏
䮸	𬳸
䮽	𬴍
䮾	𩧪
䮿	𬴏
䯀	䯅
䯃	𩣑
䯄	騧
䯅	䯀
䯌	尻
䯤	𩩈
䯻	髻
䰎	𱆃
䰐	𱆅
䰖	𱆈
䰗	鬮
䰫	𱆙
䰲	𱇍
䰷	𬶆
䰻	𱇕
䰽	𱇑
䰾	鲃
䱀	𫚐
䱁	𫚏
䱂	𱇤
䱅	鮇 𱇚
䱇	鱓 𱇞
䱌	𱇬
䱍	𬶊 䱎
䱎	𱇥 䱍
䱐	𱇲
䱒	𱇰
䱓	𬶓
䱗	𮬞
䱙	𩾈
䱚	𮬠
䱛	𮬟
䱜	𱇷
䱟	𱈀
䱡	𱇽
䱤	𱇻
䱥	𱇹
䱧	𫚠
䱬	𩾊
䱭	𱈇
䱰	𩾋
䱱	𬶤
䱴	𱈈
䱵	𮬢
䱷	䲣 漁
䱸	𫠑
䱹	𬶣
䱻	𮬡
䱽	鯧 䲝
䱾	𱈆
䲁	鳚
䲅	𫚜
䲉	𱈒
䲏	𬶗
䲕	𬶴
䲖	𩾂
䲗	𮬣
䲘	鳤
䲙	𬶎
䲚	𱈖
䲛	𱈛
䲝	䱽
䲞	𩶘
䲟	鮣
䲠	鰆
䲡	鰌
䲢	鰧
䲣	䱷
䲤	鿐
䲨	𬷾
䲰	𪉂
䲸	𮭡
䲹	𱉖
䲼	𬸆
䳅	𱉙
䳇	𱉞
䳍	𮭥
䳏	𱉤
䳒	𱉧
䳓	𱉦
䳕	𱉺
䳚	𱉶
䳜	𫛬
䳟	𱊂
䳢	𫛰
䳤	𫛮
䳧	𫛺
䳨	𬸛
䳫	𫛼
䳭	𱉼
䳮	𱊓
䳲	𱊙
䳺	𱊣
䴇	𱊪
䴈	𬸩
䴉	鹮
䴋	𫜅
䴓	鳾
䴔	鵁
䴕	鴷
䴖	鶄
䴗	鶪
䴘	鷈 鷉
䴙	鸊 鷿
䴚	𮭰
䴝	𱊼
䴬	𪎈
䴭	𬹅
䴮	𱋆
䴱	𫜒
䴲	𱋊
䴳	𱋎
䴴	𪎋
䴵	𱋔
䴷	𬹉
䴸	𱋗
䴹	𱋙 餜
䴺	𱋝
䴽	𫜔
䵂	𱋪
䵃	𱋫
䵆	𱋮
䵐	𱋴
䵑	䵒
䵒	䵑
䵘	𬓸
䵳	𪑅
䵴	𫜙
䵶	𱌁
䵷	𱌃
䶏	涕
䶕	𫜨
䶗	𮯙
䶢	𬺍
䶣	𬺃
䶦	𬺉
䶧	𱌰
䶨	𱌵
䶪	𬺕
䶮	龑
䶱	𱍇
䶲	𫜳
一	弌 壹
七	柒
万	卍 萬
三	叁
与	與
丐	匃
丑	醜
专	專
丕	仳
丘	坵 㐀
业	業
丛	叢
东	東
丝	絲
丟	丢
両	兩 两
丢	丟
两	兩 両
严	嚴
並	幷 并 竝
丧	喪
个	個 箇
中	塚
丰	豐
临	臨
为	為
丼	井
丽	麗
举	舉
乃	迺 廼
么	麽 幺 麼
义	義
乌	烏
乐	樂
乔	喬
乚	隱
九	玖
习	習
乡	鄉
书	書
买	買
乱	亂
乾	亁 干
亁	乾
亂	乱
予	余
争	爭
亊	事
事	亊
二	弍 貳
于	於 扵
亏	於 虧 扵
云	雲
五	伍 㐅
井	丼
亗	𡻕 岁 歲
亚	亞
亝	齊
亞	亚
亡	兦 亾
产	產
亩	畝
亲	榛 親
亵	褻
亸	嚲
人	亻
亻	人
亼	集
亾	亡
亿	億
仅	僅
仆	僕
仇	讎 讐
从	從
仑	侖
仓	倉
他	牠 她
仙	僊
仝	同
仟	千 阡
以	㠯
仪	儀
们	們
仳	丕
价	價
任	仼
仼	任
份	分
仾	低
仿	倣
伀	彸
伃	妤
伍	五
众	眾
优	優
会	會
伛	傴
伞	傘
伟	偉
传	傳
伡	俥
伣	俔
伤	傷
伥	倀
伦	倫
伧	傖
伪	偽 僞
伫	佇
伭	玄
伱	你
伷	冑 胄
佅	𠇱
佇	竚 伫
佋	紹
低	仾
佑	祐
体	體 軆
佔	占
佗	它
余	余 餘 予
你	您 伱 妳 祢 袮
佣	傭
佥	僉
佬	姆
佰	百
併	并 倂 𠊧
侁	詵 駪
侂	託
侅	賅
來	来 耒
侎	敉
侖	仑 崙
侚	狥 殉
侠	俠
侣	侶
侥	僥
侦	偵
侧	側
侨	僑
侩	儈
侪	儕
侬	儂
侮	㑄
侶	侣
俁	俣
係	系
俈	嚳
俓	𠇹 勁 徑
俔	伣
俞	兪
俟	竢
俠	侠
俣	俁
俥	伡
俦	儔
俨	儼
俩	倆
俪	儷
俫	倈
俭	儉
俯	頫
俻	備
倀	伥
倂	併
倆	俩
倈	徠 勑 俫
倉	仓
個	箇 个
倏	倐
倐	倏
們	们
倖	幸 囟
倘	儻
倣	仿
値	值
倫	伦
倲	㑈
债	債
值	値
倾	傾
偁	穪 稱
偃	㫃
偉	伟
偊	踽
偎	渨
偐	贗 贋
偑	㐽
偒	蕩
健	徤
偩	𰁾
偪	逼
偬	傯
側	侧
偵	侦
偷	偸
偸	偷
偺	咱 喒 昝
偻	僂
偽	伪
偾	僨
偿	償
傁	叜 墰 叟
傌	㐷 罵
傍	旁
傏	搪
傑	杰
傖	伧
傘	伞 繖
備	俻 备
傜	徭
傥	儻
傧	儐
储	儲
傩	儺
傪	𫢺
傭	佣
傯	偬
傱	𰁧
傳	传
傴	伛
債	债
傷	伤
傻	儍
傽	慞
傾	倾
僀	𰂗
僂	偻
僅	仅
僆	𫢪
僉	佥
僊	仙
働	𫢙
僑	侨
僓	𰂜
僕	仆
僗	𫢬
僞	伪
僤	𫢸
僥	侥
僨	偾
僩	𰂎
僱	雇
僴	𰂋
價	价
僾	𫣊
儀	仪
儁	㑺
儂	侬
億	亿
儅	𰁸
儆	警
儈	侩
儉	俭
儍	傻
儎	載
儐	傧
儒	㐵
儓	檯 枱
儔	俦
儕	侪
儖	𫣉
儘	尽
儛	㒇
償	偿
儡	酹
儢	𰂦
儣	𠆲
儥	𰂏
儩	𰂭
優	优
儭	襯
儰	𫢭
儱	𫢒
儲	储
儶	㒞
儷	俪
儸	㑩
儹	𰃆
儺	傩
儻	傥 倘
儼	俨
儿	兒
克	剋
兌	兑
兎	兔
兑	兌
兒	儿
兔	兎
兖	兗
兗	兖
党	黨
兦	亡
內	内
全	㒰
兩	两 両
兪	俞
八	捌
六	陸
兮	𠔃
兰	蘭
关	關
兴	興
兹	玆 茲
养	養
兽	獸
冁	囅
冂	坰 冋
冄	冉
内	內
冈	岡
冉	冄
冊	册
冋	坰 冂
册	冊
冑	伷 胄
冒	冒
冗	宂
写	寫
军	軍
农	農
冤	寃
冩	寫
冪	鼏 羃 幂
冫	冰 氷
冯	馮
冰	冫 氷
冱	沍
冲	沖 衝
决	決
况	況
冻	凍
净	凈
凂	浼
凄	淒
准	準
凈	净 淨
凉	涼
凍	冻
减	減
凐	湮
凑	湊
凒	溰
凓	溧
凔	滄 𰃷
凗	漼
凘	澌
凙	澤 𪞝
凚	澿
凛	凜 懔
凜	澟 凛
凟	𰃿 瀆
几	幾
凡	凣 凢
凢	凡
凣	凡
凤	鳳
処	處 䖏
凫	鳧
凭	憑
凯	凱
凱	凯
凳	櫈
凴	憑
凶	㐫
凹	𠕄
出	岀 齣 出
击	擊
函	圅 凾
凾	函 圅
凿	鑿
刀	刂
刂	刀
刃	刄
刄	刃
刅	創
分	份
刊	刋
刋	刊
刍	芻
划	劃
刓	园
刘	劉
则	則
刚	剛
创	創
删	刪
別	别
刦	刧 劫
刧	劫 刦
刨	鉋
利	𥝢
刪	删
别	別
刬	剗
刭	剄
刮	颳
刱	創
刴	剁
制	製
刷	㕞
刹	剎
刺	莿
刼	劫
刽	劊
刾	㓨
刿	劌
剀	剴
剁	刴
剂	劑
剃	鬀
剄	刭
則	则
剉	銼
剋	克 尅
剌	巤
剎	刹
剐	剮
剑	劍
剗	刬 剷
剙	創
剛	刚
剝	剥
剥	剝
剦	閹
剧	劇
剩	賸
剪	翦
剮	剐
剳	劄
剴	剀
創	创 刅 剙 刱 戧
剷	剗
剸	𰄞
剾	𠛅
剿	𠞰
劃	划
劄	剳
劇	剧
劈	擗
劉	刘
劊	刽
劌	刿
劍	剑 劒
劎	劔
劏	㓥
劑	剂
劒	劍
劓	㓷
劔	劎
劗	𭄛
劚	㔉
劝	勸
办	辦
务	務
劢	勱
动	動
劫	刧 刼 刦
励	勵
劲	勁
劳	勞
効	效
势	勢
勁	俓 劲
勄	敏
勅	敕 勑
勋	勛
勑	徠 敕 倈 𠡠 勅
動	动
勖	勗
勗	勖
務	务
勚	勩
勛	勳 勋
勝	胜
勞	劳
勢	势
勣	𪟝
勩	勚
勰	恊 協 脅
勱	劢
勳	勛
勴	𰅔
勵	励
勸	劝
勹	包
勻	匀
勽	㲒 菢
匀	勻
匃	匄 丐
匄	匃
包	勹
匆	悤 怱
匈	胸 胷
匊	掬
匋	陶
匏	瓟
匘	腦
匙	鍉
匝	迊 帀
匦	匭
匧	篋
匭	匦
匮	匱
匯	汇 滙
匰	𰅦
匱	櫃 饋 鐀 匮 樻
匳	奩
匵	櫝 𰅥
匹	疋
区	區
医	醫
區	区
十	拾
千	仟
卄	廿
卉	芔
卌	𠦌 𠦜
卍	萬 卐 万
华	華
协	協
卐	卍
卒	䘚
卓	棹
協	旪 协 勰
单	單
卖	賣
博	愽
占	佔
卢	盧
卤	鹵
卧	臥
卨	𫧯
卩	節 㔾
卫	衛
卬	卭
卭	卬
即	卽
却	卻
卹	恤
卻	却
卽	即
厂	廠
厄	戹
厅	廳
历	歷 厲 曆
厉	厲
压	壓
厌	厭
厍	厙
厎	砥
厐	龎
厓	崖
厕	廁
厖	庬
厘	𭀖 釐
厙	厍
厠	廁
厢	廂
厣	厴
厤	曆
厦	廈
厨	𢊍 廚
厩	廄 廐
厪	廑
厭	厌
厮	㒋 廝
厰	廠
厱	𰆚
厲	历 厉
厴	厣
厶	某
厷	肱
厹	叴
县	縣
叁	叄 三
参	參
參	薓 参 叅
叄	叁
叅	參
叆	靉
叇	靆
叉	釵
双	雙
収	收
发	發 髮
叔	尗
变	變
叙	敍 敘
叜	叟 傁
叟	叜 墰 傁
叠	疊 曡
叡	睿
叢	丛 樷
叨	饕
只	隻 子
叫	呌
台	檯 台 臺 颱
叴	厹
叵	尀
叶	葉
号	號
叹	嘆
叽	嘰
吃	喫
吉	𠮷
吊	弔
吋	寸
同	仝 衕 同
后	后 後
向	曏 向
吒	咤
吓	嚇
吕	呂
吗	嗎
吚	咿
吝	恡 悋
吞	呑
吟	唫
吣	唚
吨	噸 啍
含	唅
听	聽
启	啟
吲	哂
吳	呉 吴
吴	吳 呉
吶	呐 訥
吸	噏
吹	龡
吻	肳 呡
吿	告
呂	吕
呃	阨
呆	獃
呉	吳 吴
告	吿
呌	叫
呐	吶
呑	吞
呒	嘸
呓	囈
呕	嘔
呖	嚦
呗	唄
员	員
呙	咼
呛	嗆
呜	嗚
呠	噴 歕
呡	吻
周	週
呪	詋 咒
味	𠰌
呴	詬
咀	嘴 觜
咂	𠯗
咊	龢 和
和	龢 咊
咏	詠
咒	呪
咙	嚨
咛	嚀
咝	噝
咤	吒
咥	嘻
咨	諮 嗞
咩	哶
咬	齩
咮	胄
咱	偺 喒
咲	笑
咳	欬
咷	啕
咸	鹹
咼	呙
咽	嚥
咿	吚
哂	吲
响	響
哑	啞
哒	噠
哓	嘵
哔	嗶
哕	噦
哗	嘩
哙	噲
哜	嚌
哝	噥
哟	喲
員	员
哦	誐
哯	𠯟
哲	悊 喆
哴	喨
哶	咩
哼	苛
唁	喭
唄	呗
唅	含
唇	脣
唉	欸
唊	𰇕 硤
唓	𪠳
唚	吣
唛	嘜
唝	嗊
唠	嘮
唡	啢
唢	嗩
唤	喚
唫	吟
唬	虓 猇 諕
唻	𫪁
唾	涶
啃	齦
啊	阿
啍	吨
啎	忤
問	问
啓	啟
啕	咷
啖	啗 㗖 噉
啗	㗖 啖 噉
啜	歠 諁 欼
啞	瘂 哑
啟	啓 启
啢	唡
啣	㘅
啧	嘖
啬	嗇
啭	囀
啮	嚙
啯	嘓
啰	囉
啴	嘽
啸	嘯
啼	嗁
喂	餧 餵
喃	諵
喆	哲
喎	㖞
喐	郁
喒	偺 咱 昝
喚	唤
喜	憙
喧	諠
喨	哴
喪	丧
喫	吃
喬	乔
喭	唁
單	单
喲	哟
喷	噴
喽	嘍
喾	嚳
喿	噪
嗁	啼
嗅	齅
嗆	呛
嗇	啬
嗉	膆
嗊	唝
嗎	吗
嗒	㗳
嗚	呜
嗞	咨 諮
嗥	嘷 嚎
嗧	𰇠
嗩	唢
嗫	囁
嗳	噯
嗶	哔
嗹	𪡏
嗻	處
嗽	瘶
嗿	𰇲
嘄	𫪧
嘆	叹 歎
嘇	𰇼
嘈	䜊
嘍	喽 謱
嘓	啯
嘔	慪 呕
嘖	啧
嘗	甞 尝
嘘	噓
嘜	唛
嘤	嚶
嘩	譁 哗
嘪	𪡃
嘮	唠
嘯	啸 歗
嘰	叽
嘱	囑
嘳	𪡞
嘴	咀 觜
嘵	哓
嘷	嗥
嘸	呒
嘺	𪡀
嘻	咥
嘽	啴
嘿	默
噁	𫫇
噂	譐
噅	𠯠
噉	㗖 啖 啗
噏	吸
噐	器
噑	嚎
噓	嘘
噚	㖊
噜	嚕
噝	咝
噞	𪡋
噠	哒
噥	哝
噦	𧬨 哕
器	𠾖 噐
噪	喿 譟
噯	嗳
噲	哙
噴	呠 喷 歕
噸	吨
噹	𪠽 当
嚀	咛
嚂	𰈓
嚇	吓
嚈	𫩫
嚌	哜
嚍	𫩺
嚎	嗥 噑
嚐	𰈇
嚕	噜
嚙	啮
嚛	𪠸
嚝	𫩕
嚠	𭇯
嚣	囂
嚥	咽
嚦	呖
嚧	𠰷
嚨	咙
嚩	𰈶
嚪	𫫦
嚫	𰈍
嚬	顰 𫫾
嚱	𰇣
嚲	亸
嚳	喾 俈
嚴	严
嚵	饞
嚶	嘤
嚸	𰈊
嚹	𡅈
嚽	𪢕
嚿	𫩥
囀	啭
囁	嗫 讘
囂	嚣
囅	冁
囇	𫪃
囈	呓
囉	啰
囋	𰉄
囐	𰈯
囑	嘱
囒	𪢠
囓	齧
囕	𰈆
囘	囬 回
四	肆
回	囘 廻 囬
囟	幸 顖 倖 䪿
团	團
囤	𥫱
囪	囱
囬	囘 回
园	園 刓
囮	𡈙 諤
囯	國
困	睏
囱	囪
围	圍
囵	圇
国	國
图	圖
圅	函 凾
圆	圓
圇	囵
國	国 囯
圍	围
園	园
圓	圆
圕	圖
圖	图 圕
團	团
圝	圞
圞	圝 𪢮
圢	町
圣	聖
圬	杇
圭	珪
圹	壙
场	場
坂	阪
坆	墳
坋	坌
坌	坋
坎	埳
坏	壞 坯
坐	座
坑	阬
块	塊
坚	堅
坛	罈 壇
坜	壢
坝	壩
坞	塢
坟	墳
坠	墜
坤	堃
坭	泥
坯	坏
坰	冂 冋
坵	丘
垄	壟
垅	壠
垆	壚
垒	壘
垔	堙 陻
垛	垜
垜	垛
垦	墾
垩	堊
垫	墊
垭	埡
垯	墶
垱	壋
垲	塏
垴	堖
垵	埯
垷	𰉚
垻	壩
埇	甬
埉	𰉥
埘	塒
埙	塤
埚	堝
埜	野
域	㽣 譽
埡	垭
埨	𫭢
埬	𪣆
埯	垵
埰	采
埳	坎
埶	蓺 秇 藝
執	执
基	抍 拯
埽	掃
堃	坤
堅	坚
堆	𠂤
堇	菫
堈	𰉙 罁 缸
堊	垩
堑	塹
堕	墮
堖	垴
堘	塍
堙	垔 陻
堚	𪣒
堝	埚
堤	隄
堦	階
堭	隍
堯	尧
報	报
場	塲 场
堿	鹻 鹼
塆	壪
塊	块
塋	茔
塍	堘
塏	垲
塐	塑
塑	塐
塒	埘
塔	㙮 墖
塗	涂
塚	中
塟	葬
塡	填 窴
塢	隖 坞 隝 鄔
塤	壎 埙
塩	鹽
填	塡
塲	場
塵	尘
塸	𫭟
塹	堑 壍
塼	𫭞
塾	孰
塿	𪣻
墆	𰊂
墈	磡
墊	垫
墋	𫮅
墏	𰊈
墖	塔
墙	牆
墜	坠
墝	𫭪 磽
墠	𫮃
墢	𫭨
墤	隤
墧	𰉩
墫	樽 壿 罇
墮	堕
墰	壜 罈 傁
墳	坆 坟
墶	垯
墷	𰉪
墻	廧 牆
墾	垦
墿	𰉣
壇	坛
壈	𡒄
壋	垱
壍	塹 𰊢
壎	塤
壏	𰊑
壐	璽 𡊑
壒	𭏦
壓	压
壔	𭎜
壗	𡋤
壘	垒
壙	圹
壚	垆
壛	𰊡
壜	罈 墰
壝	𭏸
壞	坏
壟	垄
壠	垅
壢	坜
壣	𪤚
壧	𫭲
壩	坝 垻
壪	塆
壬	𡈼
壮	壯
壯	𡉟 壮
声	聲
壳	殻 㱿 殼
壶	壺
壸	壼
壹	一 弌
壺	壶
壻	婿
壼	壸
壽	夀 寿
壿	墫
夀	壽 寿
处	處
夅	降
备	備
変	變
复	覆 複 復
外	舀
够	彀 夠
夠	彀 够
夢	夣 梦
夣	夢
天	靝
夯	䂫
头	頭
夸	誇
夹	夾
夺	奪
夾	夹
奁	奩
奂	奐
奇	竒
奈	柰
奋	奮
奎	奞 㚝
奐	奂
奔	犇
奕	弈
奖	獎
奞	㚝 奎
奥	奧
奧	奥
奨	獎 奬
奩	奁 匳
奪	夺
奫	𫯶
奬	奨 獎
奮	奋
奯	𫯥
奲	𫰂
奶	嬭 妳
奸	姦
她	他
奼	姹
妆	妝
妇	婦
妈	媽
妊	姙
妒	妬
妙	玅
妝	妆 粧
妤	伃
妩	嫵
妪	嫗
妫	媯
妬	妒
妳	奶 您 嬭 你 祢 袮
妹	妺
妺	妹
姆	佬 姥
姉	姊
姊	姉
姍	姗
姗	姍
姙	妊
姣	㚣
姥	姆
姦	奸
姹	奼
姻	婣
娄	婁
娅	婭
娆	嬈
娇	嬌
娈	孌
娘	孃
娙	𫰛
娛	娯 娱
娠	㛛 煖
娩	㝃
娬	嫵
娯	娛 娱
娱	娯 娛
娲	媧
娴	嫻
婁	娄
婡	𫝫
婣	姻
婦	媍 妇
婬	淫
婭	娅
婳	嫿
婴	嬰
婵	嬋
婶	嬸
婸	𰋸
婿	壻
媁	𫰍
媆	嫩 嫰
媈	𫝨
媍	婦
媜	𰌂
媧	娲
媪	媼
媭	嬃
媯	嬀 妫
媰	㛀
媼	媪
媽	妈
媿	愧
嫈	𰌀
嫉	𡜱
嫒	嬡
嫔	嬪
嫕	嫛
嫗	妪
嫛	嫕
嫢	𫰹
嫥	𰋹
嫧	𰌇
嫩	媆 𡞾 嫰
嫫	嬷
嫰	嫩 媆
嫱	嬙
嫵	妩 娬
嫺	嫻
嫻	娴 嫺
嫿	婳
嬀	媯
嬃	媭
嬅	𫰡
嬇	𫝬
嬈	娆
嬋	婵
嬌	娇 撟
嬐	𫰰
嬒	𫰢
嬙	嫱
嬡	嫒
嬣	𪥰
嬤	嬷
嬦	𫝩
嬪	嫔
嬭	奶 妳
嬮	𰋽
嬰	孾 婴
嬲	惱
嬷	嬤 嫫
嬸	婶
嬻	𪥿
嬾	𰌙
孀	霜
孃	娘
孄	𫝮
孆	𫝭
孇	𪥫
孋	㛤
孌	娈
孎	𡠟
子	只
孙	孫
孛	柏 栢
学	學
孪	孿
孫	孙
孭	𧴯
孰	塾
孲	𰌦
學	斈 学
孻	𡥧
孼	孽
孽	孼
孾	嬰 𪧀
孿	孪
宁	寧
宂	冗
它	牠 佗
完	煙 烟
宐	宜
宜	宐
宝	寳 寶
实	實
宠	寵
审	審
宪	憲
宫	宮
宮	宫
宴	讌
宻	密
宼	寇
宽	寬
宾	賓
宿	㝛
寃	冤
密	宻
寇	宼
寍	寧
寔	實
寕	寜
寗	甯
寘	置
寚	寳 宝
寜	寕
寝	寢
察	詧
寠	𪧘 窶
寡	關
寢	寝
實	实 寔
寧	寍 𡨴 宁
寨	砦
審	审
寪	𰌷
寫	冩 写
寬	宽
寯	㝦
寳	宝 寶
寵	𠖥 宠
寶	寳 宝
寷	𫲸
寸	吋
对	對
寻	尋
导	導
寿	夀 壽
尀	叵
尃	敷 旉
尅	剋
将	𤕭 將
將	畺 𤕭 将
專	专 耑
尉	熨
尋	寻
對	对
導	导
尒	爾 尔
尔	尒 爾
尗	叔
尘	塵
尝	嘗
尢	尣
尣	尢
尧	堯
尨	狵
尩	㑌
尰	腫
尲	尷
尴	尷
尵	𪨇
尷	尴 尲
尸	屍
尻	䯌
尽	儘 盡
尿	溺
层	層
屃	屓
居	㞐
屆	届
屉	屜
届	屆
屍	尸
屓	屃
屜	屉 𡲕
属	屬 𡱆
屡	屢
屢	屡
屣	躧 蹝
層	层
屦	屨
屨	屦
屩	𪨗
屬	𡱆 属
屿	嶼
岀	出
岁	𡻕 歲 亗
岂	豈
岖	嶇
岗	崗
岘	峴
岙	嶴
岚	嵐
岛	島
岡	冈 崗
岨	砠
岩	巖
岭	嶺
岽	崬
岿	巋
峄	嶧
峒	洞
峡	峽
峣	嶢
峤	嶠
峥	崢
峦	巒
峨	峩
峩	峨
峭	陗
峯	峰
峰	峯
峴	岘
島	岛
峽	峡
崂	嶗
崃	崍
崄	嶮
崋	華
崍	崃
崒	崪
崔	磪
崖	厓
崗	岡 岗
崘	崙
崙	𪨧 崘 侖
崠	𰎏
崢	峥
崧	嵩
崪	崒
崬	岽
崭	嶄
崱	𰎖
崵	𫵵
嵐	岚
嵗	歲
嵘	嶸
嵚	嶔
嵝	嶁
嵠	谿
嵩	崧
嵷	𰎌
嵸	𡵝
嵼	𡶴
嵽	𫶇
嵾	㟥
嶁	嵝
嶃	磛
嶄	巉 崭
嶇	岖 㠊
嶈	𡺃
嶎	蔚
嶔	嵚
嶗	崂
嶝	磴
嶠	峤
嶢	峣
嶤	𰎔
嶧	峄
嶩	𰎞
嶪	𰎑
嶮	崄
嶴	岙
嶸	嵘
嶹	𫝵
嶺	岭
嶼	屿
嶽	𰎫
巃	𰎎
巅	巔
巆	𫶕
巉	嶄
巊	𪩎
巋	岿
巍	魏
巑	𰏁
巒	峦
巔	巅
巖	𰎠 岩
巗	𪨷
巘	𪩘
巚	𰎹
巛	川
川	巛
巠	𢀖
巡	廵
巤	剌 鬣
巩	鞏
巯	巰
巰	巯
帀	迊 匝
币	幣
帅	帥
帆	㠶 拚
师	師
帋	紙
帏	幃
帐	帳
帒	袋
帘	簾
帙	袠
帚	箒
帜	幟
帡	帲
帥	帅
带	帶
帧	幀
師	师
帬	裙
帮	幫 幇
帱	幬
帲	帡
帳	帐 賬
帴	𰏕
帶	带
帻	幘
帼	幗
幀	帧
幂	鼏 冪
幃	帏
幇	帮 幫
幐	㬺
幓	㡎
幕	幙
幗	帼
幘	帻
幙	幕
幞	襮
幟	帜 旘
幠	𭘓
幡	旛
幣	币
幩	𪩸
幫	帮 幇
幬	帱
幰	𫷉
幱	𰏟
干	幹 乾
幵	开
并	並 幷 併 竝
幷	並 并 竝
幸	倖 囟
幹	干
幺	么
幾	几
广	廣
庄	莊
庅	麽 麼
庆	慶
床	牀
庐	廬
庑	廡
库	庫
应	應
庙	廟
庞	龐
废	廢
座	坐
庫	库
庬	厖
庲	𫷬
庵	菴
庸	㐯 𠆌
庾	斞
廀	廋
廁	厠 厕
廂	厢
廄	厩
廈	厦
廋	廀
廌	豸
廐	厩
廑	厪
廔	𫷹
廕	𫷮 蔭
廗	𰏼
廚	厨
廝	㒋 厮
廞	𫷷
廟	庙
廠	厂 厰
廡	庑
廢	废
廣	广
廥	𰏶
廧	𪪞 墻 牆
廩	廪
廪	廩
廬	庐
廮	𫷾
廱	雝
廳	厅
廵	巡
廸	迪
廹	迫
廻	迴 回
廼	乃 迺
廿	卄
开	開 幵
异	異
弃	棄
弄	瘧
弈	奕
弊	𡚁
弋	𢍺
弌	一 壹
弍	貳 二
弑	弒
弒	弑
弔	吊
张	張
弢	韜
弥	彌
弦	絃
弪	弳
弯	彎
弳	弪
張	张
強	强 彊
弹	彈
强	彊 強
彀	夠 够
彄	𫸩
彈	弹
彊	强 強
彌	弥
彍	𭚦
彎	弯
彐	彑
彑	彐
归	歸
当	噹 當
录	錄
彙	汇
彝	彞
彞	彝
彟	彠
彠	彟
彥	彦
彦	彥
彨	彲
彫	雕 㓮 鵰
彬	斌
彲	彨
彷	徬 髣
彸	伀
彻	徹
往	徃
征	徵 征
徃	往
径	徑
後	后
徑	勁 俓 径
徒	𨑒
徕	徠
從	从
徠	勑 徕 倈
御	馭 禦
徤	健
徧	遍
復	复
徬	彷
徭	傜
徵	徵 征
德	悳 惪
徹	彻 澈
徿	𪫌
心	忄 㣺
忄	心
忆	憶
忍	㣼
忏	懺
志	志 誌 𢖽
忤	啎 迕
忧	憂
忭	昪
忻	欣
忼	慷
忾	愾
怀	懷
态	態
怂	慫
怃	憮
怄	慪
怅	悵
怆	愴
怌	懷
怜	憐
怪	恠
怱	匆 悤
怳	恍
总	總
怼	懟
怽	𢗿
怿	懌
恆	恒
恊	勰
恋	戀
恍	怳
恐	𢙢
恒	恆
恠	怪
恡	悋 吝
恤	卹
恥	耻
恩	摁
恳	懇
恶	惡
恸	慟
恹	懨
恺	愷
恻	惻
恼	惱
恽	惲
恿	慂
悁	懁
悅	悦
悊	哲
悋	恡 吝
悏	𫺂
悐	惕
悚	𢥠
悞	誤 悮
悠	滺
悤	匆 怱
悦	悅
您	袮 妳 你 祢
悫	愨
悬	懸
悭	慳
悮	悞
悯	憫
悳	德
悵	怅
悶	闷 懣 㥃
惀	𰑄
惇	敦
惊	驚
惕	悐
惛	惽
惝	𢠵
惡	恶
惧	懼
惨	慘
惩	懲
惪	德
惫	憊
惬	愜
惭	慚
惮	憚
惯	慣
惱	嬲 恼
惲	恽
惺	𢜫 醒
惻	恻
惽	惛
愇	𫹴
愈	瘉 愉
愉	愈
愍	憫
愛	爱
愜	惬
愠	慍
愤	憤
愦	憒
愧	媿
愨	悫
愩	𫺌
愬	訴
愴	怆
愷	恺
愻	遜
愽	博
愾	忾
愿	愿 願
慁	㥵
慂	恿
慄	栗
慈	㤵
態	态
慍	愠
慐	𰑟
慑	懾
慘	惨
慙	𰑧 慚
慚	惭 慙
慞	傽
慟	恸
慣	惯
慪	嘔 怄
慫	怂
慭	憖
慮	虑
慯	𫹽
慱	𰑁
慲	𰒆
慳	悭
慶	庆
慷	忼
慸	𰑵
慹	𰑔
慺	㥪
慼	慽
慽	慼
慾	欲
憂	懮 忧
憇	憩
憊	惫
憋	𢠳
憍	㤭
憐	怜
憑	𠗦 凭 凴
憒	愦
憔	顦
憖	慭
憙	喜
憚	惮
憝	譈 懟
憢	𢙒
憤	愤
憦	𫺘
憩	憇
憪	𰑥
憫	愍 悯
憮	怃
憯	㦧
憰	譎
憲	宪
憴	𰑪
憶	忆
憸	𪫺
憹	𢙐
懀	𢙓
懁	悁
懇	恳
應	应 硬
懌	怿
懍	懔
懑	懣
懒	懶
懓	𭞄
懔	凛 懍
懕	𰑕
懘	𰒒
懙	𫹮
懜	𢟼 懵
懟	譈 怼 憝
懠	𫺊
懣	悶 懑 㥃
懤	㤽
懥	懫
懧	㤖
懨	恹
懩	𫺪
懫	懥 𰑬
懭	𰐾
懮	憂
懰	𰑙
懲	惩
懵	懜
懶	懒
懷	怌 怀
懸	悬
懺	忏
懼	惧
懽	欢 歡
懾	慑
戀	恋
戁	𫺷
戃	𰑿
戆	戇
戇	戆
戉	鉞
戋	戔
戏	戲
戔	戋
戗	戧
战	戰
戧	戗 創
戩	戬
戬	戩
戯	戱 戲
戰	战 𢧐
戱	戲 戯
戲	戱 戯 戏
戶	户 戸
户	戶 戸
戸	戶 户
戹	厄
扁	艑
扅	扊
扊	扅
手	扌
扌	手
才	財 纔
扎	紮
扑	撲
托	拓
扞	捍
执	執
扩	擴
扪	捫
扫	掃
扬	揚
扯	撦
扰	擾
扳	攀
扵	亏 于 於
扼	㧖 搤
抌	舀
抍	基 拯
折	拃 翼
抚	撫
抛	拋
抝	拗
抟	摶
抠	摳
抡	掄
抢	搶
护	護
报	報
披	㓟
抬	擡
抹	抺
抺	抹
抽	𢭆
抿	㨉
拃	折
担	擔
拆	責
拇	𧿹
拈	敁
拋	抛
拏	拿 挐
拓	托
拕	拖
拖	拕
拗	抝
拚	帆
拟	擬
拢	攏
拣	揀
拥	擁
拦	攔
拧	擰
拨	撥
择	擇
拭	𢂑
拯	基 抍
拼	秉 摒
拽	曳
拾	十
拿	挐 拏
挂	掛
按	搵
挐	拿 拏
挙	𢸁
挚	摯
挛	攣
挜	掗
挝	撾
挞	撻
挟	挾
挠	撓
挡	擋
挢	撟
挣	掙
挤	擠
挥	揮
挦	撏
挩	捝
挫	繲
挭	鯁 骾
挱	挲
挲	挱
挷	搒
挼	捼
挽	輓 掇
挾	挟
挿	插 揷
捆	綑
捉	杓
捌	八
捍	扞
捏	揑
捓	揶
捝	挩
捞	撈
损	損
捡	撿
换	換
捣	搗
捦	擒
捨	舍
捫	扪
捬	撫
据	據
捵	䥀
捶	箠
捷	㨗
捼	挼
掁	𰓄
掂	敁
掃	扫 埽
掄	抡
掆	㧏
掇	挽
掉	棹
掏	搯
掐	𠜼
掗	挜
掙	挣
掚	𪭵
掛	挂
採	采
掩	揞 揜
掬	匊
掳	擄
掴	摑
掷	擲
掸	撣
掺	摻
掼	摜
掽	碰
揀	拣
揅	研
揑	捏
插	揷 挿
揚	扬
換	换
揜	掩
揝	撍 攢
揞	掩
揦	攋
揪	揫
揫	揪
揭	結
揮	挥
揶	捓
揷	插 挿
揸	楂 摣
揺	搖 摇
揽	攬
揾	搵
揿	撳
搀	攙
搁	擱
搂	摟
搃	摠 總
搅	攪
搇	撳
搉	㩁
搊	𫼝
損	损
搎	𰓧
搒	挷
搖	揺 摇
搗	捣 擣
搜	𢯱 𢲷
搞	攪
搤	㧖 扼
搪	傏
搫	搬
搬	搫
搭	撘
搯	掏
搵	揾 按
搶	抢
携	攜
摀	𰓆
摁	恩
摃	𫼱
摄	攝
摅	攄
摆	擺
摇	揺 搖
摈	擯
摊	攤
摋	𢫬
摐	𪭢
摑	掴
摒	拼
摔	甩
摕	𰔇
摙	𫽁
摜	掼
摟	搂
摠	總 搃
摡	溉
摣	揸
摪	𫽣
摫	𰓻
摭	拓
摮	𢳆
摯	挚
摲	𰓼
摳	抠
摴	舒
摶	抟
摻	掺
摼	𰓱
撂	㨼
撄	攖
撆	撇
撇	撆
撈	捞
撊	𪭾
撋	𰓷
撌	𰔋
撍	揝 攢
撏	挦
撐	撑
撑	撐
撓	挠
撘	搭
撝	㧑
撟	挢 嬌
撢	撣
撣	掸 撢
撥	拨
撦	扯
撧	𪮖
撫	捬 抚
撲	扑
撳	搇 揿
撵	攆
撶	𫼧
撷	擷
撸	擼
撺	攛
撻	挞
撾	挝
撿	捡
擁	拥
擃	攮 𫼮
擄	虜 掳
擇	择
擈	𭠙
擊	击
擋	挡 𫽮 攩
擒	捦
擓	㧟
擔	担
擗	劈
據	据
擜	㩵
擞	擻
擟	𪭧
擠	挤
擡	抬
擣	𢭏 搗
擥	㩜 攬 㧛
擧	舉 𢪓
擪	𰓙
擫	𢬍
擬	拟
擯	摈
擰	拧
擱	搁
擲	擿 掷
擳	𰓜
擴	扩
擷	撷
擸	㧜
擺	摆
擻	擞
擼	撸
擽	㧰
擾	扰
擿	擲
攀	扳 㐴
攄	摅
攅	攢
攆	撵
攋	𪮶 揦
攎	𢫘
攏	拢
攑	𫽥
攒	攢
攔	拦
攖	撄
攙	搀
攛	撺
攜	携
攝	摄
攞	𫽋
攢	揝 攒 撍 攅
攣	挛
攤	摊
攦	𰓬
攧	𭣇
攩	𫽮 擋
攪	搞 搅
攬	㩜 揽 擥
攮	擃
攳	𰕁
攴	攵
攵	攴
收	収 㧃
攷	考
敁	拈 掂
敃	暋
效	効
敉	侎
敌	敵
敍	叙 敘
敎	教
敏	勄
敓	敚
敕	勅 勑
敗	䢙 败
敘	敍 叙
教	敎
敚	敓
敛	斂
敠	敪
敦	惇
敩	斆
敪	敠
数	數
敵	敌
敷	旉 尃
數	数
敺	𰕅 驅
敿	𰕈
斁	𭣧 𤢕
斂	敛
斃	毙
斄	𭤎
斅	𢽾 斆
斆	敩 鏰 斅
文	㒚 穩
斈	學
斉	齊
斋	齊 齋
斌	彬
斍	覺
斓	斕
斕	斓
斗	鬥
斚	斝
斝	檟 斚
斞	庾 㔱
斤	觔
斥	㡿
斩	斬
斬	斩
断	斷
斲	斵 㓸
斵	斲
斷	断
斸	𣃁
於	亏 于 扵
斾	旆
旁	傍
旂	旗
旆	斾
旈	旒
旉	敷 尃
旒	旈
旗	旂
旘	幟
旛	幡
旝	𰕭
旟	𭤰
无	無
旧	舊
旪	協
时	旹 時
旷	曠
旸	暘
旹	时 時
昂	昻
明	朙
昏	昬
昒	㫚
昙	曇
昜	𠃓
昝	偺 喒
映	暎
昧	昩
昩	昧
昪	忭
昬	昏
昵	暱
昷	𥁕
昻	昂
昼	晝
昽	曨
显	顯
晁	朝
時	旹 时
晅	烜
晉	晋
晋	晉
晒	曬
晓	曉
晔	曄
晕	暈
晖	暉
晚	晩
晛	𬀪
晝	昼
晡	𣇀
晣	䀿
晩	晚
晰	晳
晳	晰
暂	暫
暅	𣈶
暈	晕
暉	晖
暋	敃
暎	映
暐	𬀩
暖	娠 煖
暘	旸
暟	𬀱
暠	𣉞 皜
暢	畅
暧	曖
暫	暂
暱	昵
暴	虣
曄	晔
曆	历 歴 厤 歷
曇	昙
曉	晓
曊	𪰶
曏	向
曖	暧 瞹
曜	燿 耀
曠	旷
曡	叠 疊
曥	𣆐
曨	昽
曬	晒
曭	𭧋
曮	𰖈
曲	曲 麯
曳	拽
更	㪅
曶	㫚
書	书
曼	㬅
朁	㬱
會	会
朊	䏓
朌	肦
朏	胐
朐	鸜 鴝 胊
朓	脁
朘	脧
朙	明
望	朢
朝	晁
朞	稘
期	逞
朢	望
朣	膧
朥	𦛨
朦	䑃 矇
朧	矓 胧
术	術
朳	杷
朴	樸
朵	朶
朶	朵
机	機
朿	莿
杀	殺
杂	雜
权	權
杆	桿
杇	圬
村	邨
杓	捉
杝	柂
杠	槓
条	條
来	來
杧	芒
杨	楊
杩	榪
杮	柿
杯	盃
杰	傑
東	东
杷	朳
杸	殳
松	鬆
板	闆 板 版
极	极 極
构	構
枏	楠
果	菓
枞	樅
枢	樞
枣	棗
枥	櫪
枧	梘
枨	棖
枪	槍
枫	楓
枬	楠
枭	梟
枱	檯 儓
架	榢
枺	㭑
枾	柹
柁	舵
柂	杝
柄	棅
柏	孛 栢
某	厶
柒	七
柚	櫾
柜	櫃
柠	檸
查	査
柰	奈
柳	檉
柵	栅
柹	枾
査	查
柽	檉
柿	杮
栀	梔
栅	柵
标	檁 標
栈	棧
栉	櫛
栊	櫳
栋	棟
栌	櫨
栎	櫟
栏	欄
树	樹
栒	簨
栖	棲
栗	慄
栛	荔
栢	柏 孛
栰	筏
样	樣
栾	欒
桌	棹
桠	椏
桡	橈
桢	楨
档	檔
桤	榿
桥	橋
桦	樺
桧	檜
桨	槳
桩	樁
桪	樳
桱	𣐕
桼	㯃 漆
桿	杆
梁	樑
梔	栀
梖	𪱷
梘	枧
梜	𬂩
條	条 糶
梟	枭 鴞
梦	夢
梨	棃
梲	棁 棳
梹	檳
梼	檮
梾	棶
梿	槤
检	檢
棁	梲
棂	欞
棃	梨
棄	弃
棅	柄
棆	𰗖
棊	棋 碁
棋	棊 碁
棐	榧
棑	篺
棕	㯶 椶
棖	枨
棗	枣
棟	栋
棡	㭎
棥	樊
棧	栈
棰	槌
棱	楞 稜
棲	栖
棳	梲
棶	梾
棹	桌 卓 櫂
椀	碗 盌
椁	槨
椎	槌
椏	桠
椚	𭩛
椝	槼
椟	櫝
椠	槧
椢	槶
椤	欏
椫	樿
椭	橢
椮	槮
椰	㭨
椲	㭏
椶	棕
椹	葚
楂	槎 揸
楇	𣒌
楊	杨
楎	𰗢
楓	枫
楞	棱 稜
楠	枬 枏
楥	楦
楦	楥
楨	桢
楫	檝 艥
業	业
極	极
楼	樓
概	槩
榄	欖
榅	榲
榇	櫬
榈	櫚
榉	櫸
榎	檟
榛	亲
榝	樧 𬂮
榢	架
榧	棐
榨	醡 酢
榪	杩
榮	荣
榯	𰗨
榲	榅
榴	橊
榿	桤
槀	稿
槊	鎙
構	构
槌	棰 椎
槍	枪
槎	楂
槓	杠 篢
槖	橐
槚	檟
槛	檻
槟	檳
槠	櫧
槤	梿
槧	椠
槨	椁
槩	㮣 概
槪	㮣
槫	𣏢
槮	椮
槳	桨
槶	椢
槹	𣓌
槻	𬃀
槼	椝
樁	桩
樂	乐
樅	枞
樊	棥
樐	櫓 㯭 艪
樑	梁
樓	楼
標	标
樚	轆
樞	枢
樠	𣗊
樢	㭤
樣	样
樧	榝
横	橫
樫	㭴
樯	檣
樱	櫻
樲	𬃘
樳	桪
樷	叢
樸	朴
樹	树
樺	桦
樻	𭫀 櫃 匱
樽	罇 墫
樿	椫
橃	𭩰
橅	𬂠
橆	無
橇	鞽
橈	桡
橊	榴
橋	桥
橐	槖
橓	蕣
橚	𰗹
橛	橜
橜	橛
機	机
橢	椭
橥	櫫
橨	𰗺
橫	横
橯	𣓿
橱	櫥
橹	櫓
橼	櫞
檁	标 檩
檂	𬂰
檉	柽 柳
檋	𰘈
檐	簷
檒	𮨴
檔	档 欓
檛	簻 𭪆
檜	桧
檝	楫 艥
檟	榎 斝 槚
檠	𢐧
檡	𰗛
檢	检
檣	艢 樯
檥	𭩚
檩	檁
檭	𣘴
檮	梼
檯	枱 儓 台
檰	𰘣
檲	𣑝
檳	梹 㯽 槟
檴	穫
檵	𪲛
檸	柠
檻	槛
檾	䔛 𰘓
檿	𰗜
櫂	棹 掉
櫃	柜 匱 饋 鐀 樻
櫅	𪲎
櫈	凳
櫌	耰
櫍	𬃊
櫎	𰗓
櫏	𰗬
櫓	橹 㯭 樐 艪
櫚	榈
櫛	栉
櫝	匵 椟
櫞	橼
櫟	栎
櫠	𪲮
櫢	𰘸
櫥	橱
櫧	槠
櫨	栌
櫩	𰘠
櫪	枥
櫫	橥
櫬	榇
櫯	𰘶
櫱	蘖
櫳	栊 㰍
櫴	𰘳
櫶	𬃫
櫸	榉
櫹	𰘩
櫺	欞
櫻	樱
櫽	𬄩
櫾	柚
欄	栏
欇	𪳍
權	权
欍	𣐤
欏	椤
欐	𪲔
欑	𪴙
欒	栾
欓	𣗋 檔
欖	榄
欘	𣚚
欝	鬱
欞	棂 櫺
欢	歡 懽
欣	忻
欤	歟
欧	歐
欬	咳
欲	慾
欵	款
欶	𠲿
欸	唉
欹	猗
欼	啜 歠
欽	钦
款	欵
歄	𬅥
歌	謌
歍	𰙋
歎	嘆
歐	欧
歕	呠 𬅫 噴
歗	嘯 𰙑
歛	𰙎
歞	𪴯
歟	欤
歠	啜 欼
歡	欢 懽
歱	踵
歲	岁 嵗 𡻕 歳 亗
歳	歲
歴	歷 曆
歷	历 歴 曆
歸	归
歹	歺 𣦵 𣦶
歺	歹
歼	殲
歿	殁
殁	歿
殃	䄃
殇	殤
殉	狥 侚
残	殘
殍	莩
殒	殞
殓	殮
殘	残
殚	殫
殞	殒
殡	殯
殢	𣨼
殤	殇
殨	㱮
殫	殚
殮	殓
殯	殡
殰	㱩 𦢌
殲	歼
殳	杸
殴	毆
殺	杀
殻	壳 殼
殼	殻 壳 㱿
殽	淆
毀	毁
毁	毀
毂	轂
毄	𬆦
毆	殴
毊	𪵑
毓	育
毕	畢
毗	毘
毘	毗
毙	斃
毡	氈
毧	㲓
毵	毿
毶	𣯶
毿	毵
氀	𰚦
氂	牦
氅	鷩
氇	氌
氈	毡 氊
氊	氈
氌	氇
氓	甿
气	氣
氜	陽 阳
氢	氫
氣	气 炁
氤	絪
氩	氬
氫	氢
氬	氩
氭	𣱝
氯	綠
氲	氳
氳	氲
水	氵
氵	水
氷	冰 冫
氼	溺
汇	彙 匯
汉	漢
汎	泛
汙	洿 汚 污
汚	洿 汙
污	汙
汤	湯
汨	汩
汩	汨
汫	阱
汹	洶
決	决
沈	瀋 沉
沉	沈
沍	冱
沒	没
沖	冲
沟	溝
没	沒
沣	灃
沤	漚
沥	瀝
沦	淪
沧	滄
沨	渢
沩	溈
沪	冱 滬
沫	沬
沬	沫
沱	沲
沲	沱
沸	㵒
況	况
泄	洩 渫
泉	洤
泛	汎
泝	遡
泞	濘
泡	箔
泥	坭
注	註 注
泪	淚
泶	澩
泷	瀧
泸	瀘
泺	濼
泻	瀉
泼	潑
泽	澤
泾	涇
洁	潔
洒	灑
洞	峒
洤	泉
洩	泄 渫
洶	汹
洼	窪
洿	汚 汙
浃	浹
浅	淺
浆	漿
浇	澆
浈	湞
浉	溮
浊	濁
测	測
浍	澮
济	濟
浏	瀏
浐	滻
浑	渾
浒	滸
浓	濃
浔	潯
浕	濜
浚	濬
浣	澣
浹	浃
浼	凂 潣
浿	𬇙
涂	塗
涅	湼
涇	泾
涌	湧
涎	㳄
涕	䶏
涖	蒞 莅
涗	涚
涚	涗
涛	濤
涝	澇
涞	淶
涟	漣
涠	潿
涡	渦
涢	溳
涣	渙
涤	滌
润	潤
涧	澗
涨	漲
涩	澀
涶	唾
涷	𰛒
涼	凉
淀	澱
淆	殽
淒	凄
淚	泪
淜	漰
淡	澹
淥	渌
淨	凈
淪	沦
淫	婬
淳	湻
淵	渊
淶	涞
淹	渰
淺	浅
渊	淵
渌	淥
渍	漬
渎	瀆
渐	漸
渑	澠
渔	漁
渖	瀋
渗	滲
渙	涣
渚	陼
減	减
渢	沨
渦	涡
渨	偎 隈
温	溫
渫	𠗨 洩 泄
測	测 𠗧
渰	淹
渹	訇 𢕐
渾	浑
湆	𠗥
湊	凑
湋	𣲗
湌	飡
湏	須
湑	醑
湞	浈
湧	涌
湮	凐
湯	汤
湳	㓓
湶	𠗯
湻	淳
湼	涅
湾	灣
湿	濕
溁	濚
溃	潰
溅	濺
溆	漵
溇	漊
溈	沩 潙
溉	摡
溏	𠗶
溓	𠗳
準	准
溝	沟
溡	𪶄
溤	𰛊 馮
溧	凓
溫	温
溮	浉
溯	遡 㴑
溰	凒 𰛥
溳	涢
溺	尿 氼
溻	褟
溼	濕
溽	縟
滂	𠗵
滄	沧 凔
滅	烕 㓕 灭
滌	涤
滎	荥
滗	潷
滙	匯
滚	滾
滞	滯
滟	灧
滠	灄
满	滿
滢	瀅
滤	濾
滥	濫
滦	灤
滨	濱
滩	灘
滪	澦
滬	沪
滭	𰛡 㓖
滯	滞
滲	𠗿 渗
滷	𰛮
滸	浒
滺	悠
滻	浐
滾	菌 滚
滿	满
漁	渔 䱷
漆	㯃 桼
漇	𢳜
漊	溇
漍	𬇹
漎	𰛏 潨
漐	𰛣
漓	灕
漙	𬇘
漚	沤
漢	汉
漣	涟
漤	灠
漫	澷
漬	渍
漰	淜
漱	𠘂
漲	涨
漵	溆
漸	渐
漺	𠗾
漻	𠗽
漼	凗
漾	瀁
漿	𤕯 浆
潁	颍
潆	瀠
潇	瀟
潋	瀲
潍	濰
潑	泼
潔	㓗 洁
潙	溈
潚	㴋
潛	潜
潜	潛
潝	㴔
潣	𫞗 浼
潤	润
潦	澇
潨	漎
潬	𬈁 灘
潯	浔
潰	溃
潴	瀦
潷	滗
潹	𠘆
潺	𠘈
潿	涠
澀	澁 瀒 涩 濇
澁	澀 濇
澅	𣶩
澆	浇
澇	潦 涝
澈	徹
澋	𠘉
澌	凘
澒	𭱊
澖	𰛵
澗	涧 磵
澛	瀂
澜	瀾
澟	凜
澠	渑
澢	𭰎
澣	浣
澤	泽 凙
澦	滪
澩	泶
澫	𬇕
澬	𫞚
澮	浍 𠘎
澰	𰛲
澱	淀
澳	襖 𥜌
澶	𠘐
澷	漫
澹	淡
澾	㳠
澿	凚
濁	浊
濃	浓 𠘊
濄	㳡
濆	𣸣
濇	澁 澀 𬈧 瀒
濊	𰛦
濎	𠘋
濑	瀨
濒	瀕
濕	溼 湿
濘	泞
濚	溁
濛	霥 靀
濜	浕
濟	济
濤	涛
濧	㳔
濪	𩇝
濫	滥
濬	浚
濰	潍
濱	濵 滨 瀕
濵	濱 瀕
濶	闊
濺	溅
濼	泺 𠘙
濾	滤
濿	𪵱 砅
瀁	𰜝 漾
瀂	澛
瀃	𣽷
瀄	𰛤
瀅	滢
瀆	渎 凟
瀇	㲿
瀈	𰝍
瀉	泻
瀋	沈 渖
瀏	浏
瀒	澀 濇
瀕	濵 濱 濒
瀘	泸
瀙	𰜜
瀝	沥 𠘟
瀟	潇
瀠	潆
瀢	𬉋
瀤	𠘠
瀦	潴
瀧	泷
瀨	𠘝 濑
瀯	𰝅
瀰	㳽
瀲	潋
瀳	𰜨
瀴	𰜳
瀵	𬉂
瀾	澜
灂	𠘣
灃	沣
灄	滠
灍	𫞝
灏	灝
灑	洒
灒	𪷽
灓	𰛪
灕	漓
灘	潬 滩
灙	𣺼
灝	灏
灟	𭲫
灠	漤 𰜐
灡	㳕 𬉠
灣	湾
灤	滦
灦	𰝤
灧	滟
火	灬
灬	火
灭	滅
灯	燈
灰	灰
灴	烘
灵	靈
灶	竈
災	烖 菑 灾
灾	烖 菑 災
灿	燦
炀	煬
炁	氣
炉	爐
炜	煒
炝	熗
炤	照
炫	衒
炮	礮 炰 砲
炯	烱
炰	炮
炸	煠
点	點
為	爲 为
炼	煉
炽	熾
烁	爍
烂	爛
烃	烴
烊	煬
烏	乌
烕	滅
烖	菑 灾 災
烘	灴
烛	燭
烜	晅
烝	蒸
烟	煙 菸 完
烦	煩
烧	燒
烨	燁
烩	燴
烫	燙
烬	燼
热	熱
烱	炯
烴	烃
焕	煥
焖	燜
焘	燾
焛	𬮟
無	橆 无
焰	燄
煅	鍛
煆	鍜
煇	輝 𪸩
煉	炼
煑	煮
煒	炜
煖	暖 娠
煙	菸 烟 完
煠	炸
煢	茕
煥	焕
照	炤
煩	烦
煬	炀 烊
煮	煑
煱	㶽
煳	㷻
煴	熅
煼	𬊂
熂	𪸕
熅	煴
熇	燺
熈	熙
熉	𤈶
熌	𤇄
熏	燻 𤑕
熒	荧
熓	𤆡
熔	鎔
熕	𬊎
熗	炝
熙	熈
熞	𰞤
熡	𤋏
熨	㷉 尉
熰	𬉼
熱	𤍠 热
熲	颎
熾	炽
燀	𬊤
燁	烨
燄	焰
燈	灯
燌	𰞻
燐	㷠 粦
燒	簫 烧
燖	𬊈
燘	𬊖
燙	烫
燜	焖
營	营
燡	𰞇
燦	灿
燭	烛
燰	𬊺
燴	烩
燵	𬊉
燶	㶶
燺	熇
燻	熏
燼	烬
燽	𬊍
燾	焘
燿	耀 曜
爁	𬊶
爃	𫞡
爄	𤇃
爍	烁
爐	炉
爓	𰟘
爖	𤇭
爛	烂
爣	𬊵
爥	𪹳
爧	𫞠
爪	㕚 爫
爫	爪 㕚
爭	争
爱	愛
爲	為
爷	爺
爺	爷
爾	尒 尔
爿	𤕪
牀	床
牄	蹌
牆	廧 墙 墻
版	板
牋	𰠛 箋
牍	牘
牕	窻 窓 窗
牘	牍
牛	牜
牜	牛
牟	麰
牠	它 他
牦	氂
牴	牴 觝
牵	牽
牺	犧
牼	𰠲
牽	牵
犁	犂
犂	犁
犄	踦
犅	𰠫
犇	奔
犊	犢
犓	𬌝
犖	荦
犞	𪺭
犢	犊
犤	𰠹
犧	牺
犬	犭
犭	犬
犲	豺
犴	豻
状	狀
犷	獷
犸	獁
犹	猶
狀	状
狈	狽
狝	獮
狞	獰
狥	殉 侚
独	獨
狭	狹
狮	獅
狯	獪
狰	猙
狱	獄
狲	猻
狵	尨
狷	獧
狸	貍
狹	狭 陜
狻	䝜
狽	狈
猃	獫
猇	唬 虓
猋	飇 颮
猌	𪺽
猍	𰡎
猎	獵
猕	獼
猗	欹
猙	狰
猡	玀
猧	𰡏
猨	猿 蝯
猪	豬
猫	貓
猬	蝟
献	獻
猶	犹
猻	狲
猿	猨 蝯
獁	犸
獃	呆
獄	狱
獅	狮
獊	𪺷
獎	奬 奨 奖
獐	麞
獑	𰡔
獖	𰡞
獟	𬌮
獠	䝤
獢	𰡊
獧	狷
獨	独
獩	𤞃
獪	狯
獫	玁 猃
獭	獺
獮	狝
獰	狞
獱	㺍
獲	获
獵	猎 𤢪
獷	犷
獸	兽
獹	𰡄
獺	獭
獻	献
獼	猕
獾	貛
玀	猡
玁	獫 𤞤
玂	𰡩
玄	伭
玅	妙
玆	茲 兹
玑	璣
玖	九
玙	璵
玚	瑒
玛	瑪
玟	玫
玫	玟
玮	瑋
环	環
现	現
玱	瑲
玳	瑇
玺	璽
珉	䃉 砇
珍	珎
珎	珍
珐	琺
珑	瓏
珪	圭
珰	璫
珲	琿
珷	碔
珼	𫞥
現	现
琄	鞙
琅	瑯
琉	瑠
琎	璡
琏	璉
琐	瑣
琖	𬍙
琺	珐
琼	瓊
琿	珲
瑇	玳
瑋	玮
瑒	玚
瑙	𰡻 碯
瑠	琉
瑣	琐
瑤	瑶
瑩	莹
瑪	玛
瑯	琅
瑲	玱
瑶	瑤
瑷	璦
瑸	璸
瑻	𪻲
瑽	𪻐
璁	𤧚
璃	瓈
璇	璿
璉	琏
璊	𫞩
璎	瓔
璕	𬍤
璗	𬍡
璛	𰢄
璝	𪻺
璡	琎
璢	琉
璣	玑
璦	瑷
璫	珰
璯	㻅
環	环
璵	玙
璸	瑸
璹	𰡽
璼	𫞨
璽	壐 玺
璾	𫞦
璿	璇
瓄	𪻨
瓅	𬍛
瓈	璃
瓊	琼
瓏	珑
瓐	𰡵
瓒	瓚
瓓	𬎑
瓔	璎
瓕	𤦀
瓚	瓒
瓛	𤩽
瓟	匏
瓮	甕 罋
瓯	甌
瓶	缾
瓷	磁
甊	𰢦
甌	瓯
甎	磚
甒	𰢢
甕	罋 瓮
甖	𰢤 罃 罌
甞	嘗
產	产
甤	蕤
甦	穌
甩	摔
甬	埇
甯	寗
电	電
町	圢
画	畫
甽	畎
甾	菑
甿	氓
畄	畱 留
畅	暢
畆	畝
畊	耕
畎	甽
留	畄 畱
畝	亩 畆
畢	毕
略	畧
畧	略
畫	画 畵
異	异
畱	畄 留
畴	疇
畵	畫
當	当
畺	疆 將
畽	疃
疃	畽
疆	畺 將
疇	畴
疊	叠 曡
疋	匹
疍	蛋
疎	疏
疏	疎
疖	癤
疗	療
疟	瘧
疠	癘
疡	瘍
疣	肬
疬	癧
疭	瘲
疮	瘡
疯	瘋
疱	皰
疴	痾
疸	癉
疹	胗
症	癥
痈	癰
痉	痙
痐	蚘
痒	癢
痖	瘂
痙	痉
痨	癆
痪	瘓
痫	癇
痮	脹 𪽪
痲	痳
痳	痲
痴	癡
痹	痺
痺	痹
痼	㽽
痾	疴
瘂	啞 痖
瘅	癉
瘆	瘮
瘉	愈 癒
瘋	疯
瘍	疡
瘑	𬏮
瘒	𬏫
瘓	痪
瘗	瘞
瘘	瘺
瘞	瘗
瘡	疮
瘧	弄 疟
瘨	癲
瘪	癟
瘫	癱
瘮	瘆
瘱	𪽷
瘲	疭
瘶	嗽
瘺	瘘 瘻
瘻	瘺
瘾	癮
瘿	癭
療	疗
癆	痨
癇	痫
癈	𬏦
癉	疸 瘅
癎	𰣯
癐	𤶊
癒	瘉
癘	疠
癞	癩
癟	瘪
癠	𰣬
癡	痴
癢	痒
癣	癬
癤	疖
癥	症
癧	疬
癩	癞
癪	𰣼
癫	癲
癬	癣
癭	瘿
癮	瘾
癯	臞
癰	痈
癱	瘫
癲	癫 瘨
癴	𰣽
登	豋
發	发
百	佰
皁	皂
皂	皁
皃	貌 貎
皋	睾 臯
皌	𤽜
皎	㿟 皦
皑	皚
皓	皝 顥
皚	皑
皜	暠
皝	皓 顥
皞	皥 皡
皟	𤾀
皡	皥 皞
皥	皞 皡
皦	皎 㿟
皪	𰤕
皰	疱
皱	皺
皲	皸
皷	鼓 鼔
皸	皲
皺	縐 皱
皾	𰤬
盃	杯
盇	盍
益	益
盌	碗 椀
盍	盇
盏	盞
盐	鹽
监	監
盖	葢 蓋
盗	盜
盘	盤
盙	簠
盜	盗
盞	盏
盡	尽
監	监
盤	盘
盧	卢
盨	𪾔
盩	盭
盪	逿 荡 蘯 𨌩 蕩
盭	盩
眇	緲
眈	躭
眍	瞘
眎	視
眛	眜
眜	眛
眞	真
真	眞
眠	緡
眥	眦
眦	眥
眬	矓
眾	𠂝 衆 众
着	著
睁	睜
睍	𪾢
睏	困
睐	睞
睑	瞼
睔	𬑆
睜	睁
睞	睐
睪	𠬤
睫	䀹
睴	𬑕
睹	覩
睾	皋
睿	叡
瞅	矁 𬑡
瞆	瞶
瞍	𥈟
瞒	瞞
瞓	𰥛
瞘	眍
瞛	𰥒
瞜	䁖
瞞	瞒
瞠	瞪
瞡	𰥪
瞤	𥆧
瞥	苤
瞩	矚
瞪	瞠
瞬	䀢
瞯	𰥨 瞷
瞰	矙
瞱	𬑓
瞶	瞆
瞷	𬑗 瞯
瞹	曖
瞼	睑
瞿	䀠
矁	瞅 𬑡
矇	朦
矉	𪾸
矊	𬑧
矋	矖
矑	𪾦
矓	眬 朧
矕	𰥠
矖	矋 𰥢
矘	𰥹
矙	瞰
矚	瞩
矧	訠
矫	矯
矮	躷
矯	矫
矰	蹭
矲	𰦜
石	𥐘
矶	磯
矾	礬
矿	礦
砀	碭
码	碼
砅	濿
砇	珉
砌	纖
砒	磇
研	硏 揅
砖	磚
砗	硨
砚	硯
砜	碸
砞	𥑘
砠	岨
砣	鉈 𥓿
砥	厎
砦	寨
砧	碪
砲	礮 炮
砺	礪
砻	礱
砾	礫
础	礎
硁	硜
硏	研
硕	碩
硖	硤
硗	磽
硙	磑
硚	礄
硜	硁 䃘 踁
硤	唊 硖
硨	砗
硬	應
硭	𥐞
确	確
硯	砚
硵	磠
硷	礆 鹼
碁	棊 棋
碍	礙 㝵
碔	珷
碗	椀 盌
碙	𥐻
碛	磧
碜	磣
碢	𰦿
碩	硕
碪	砧
碭	砀
碯	瑙
碰	掽
碱	鹻 鹼
碸	砜
確	确
碼	码
碽	䂵
磁	瓷
磇	砒
磊	磥
磌	𧰊
磑	硙
磒	𬒍 隕
磚	砖 甎
磛	嶃
磠	硵
磡	墈
磣	碜
磥	磊
磧	碛
磪	崔
磯	矶
磱	𮀤
磴	嶝
磵	澗 𰧃
磽	墝 硗
磾	䃅
礄	硚
礆	硷
礋	𰦰
礎	础
礏	𬒆
礐	𬒈
礒	𥐟
礙	碍 㝵
礚	𥕤
礛	𰧔
礟	礮
礥	𰧇
礦	矿 鑛
礩	𰧉
礪	砺
礫	砾
礬	矾
礮	砲 𪿫 礟 炮
礰	𰦦
礱	𤮨 砻
礲	𰦭
礶	罐
礹	𰦾
示	礻
礻	示
礼	礼 禮
礿	禴
祃	禡
祇	只
祎	禕
祐	佑
祕	秘
祙	𥘯
祢	您 禰 妳 你 袮
祯	禎
祷	禱
祸	禍
祿	禄
禀	稟
禂	禱
禄	祿
禅	禪
禍	祸
禎	祯
禓	𰧰
禕	祎
禜	𰱈
禡	祃
禦	御
禪	禅
禬	𰧻
禮	礼 礼
禯	𰧾
禰	祢
禱	禂 祷
禴	礿
禵	𰨖
离	離
禿	秃
秃	禿
秄	耔
秆	稈
秇	埶 蓺 藝
秈	籼
秉	拼
秋	龝 䆋 秌
秌	秋
种	種
秏	耗
秐	耘
秔	稉 粳
秕	粃
秘	祕
秣	𥞊
秤	稱
积	積
称	稱
秸	稭
移	迻
秽	穢
秾	穠
稅	税
稆	穭
稈	秆
稉	粳 秔
稊	䄺
税	稅
稏	䅉
稘	朞
稚	稺 䕌 穉
稜	棱 楞
稟	禀
稣	穌
稬	糯
稭	秸
種	种
稱	称 秤 穪 偁
稳	穩
稺	稚
稾	稿
稿	稾 槀
穀	糓 谷
穅	糠
穇	䅟
穉	稚
穌	稣 甦
積	积
穎	颖 頴 署
穑	穡
穖	𬓠
穠	秾
穡	穑
穢	秽
穤	糯
穧	𰨦
穨	𬓼
穩	㒚 稳 文
穪	稱 偁
穫	檴 获
穬	𰨜
穭	稆
穷	窮
穽	阱
窃	竊
窌	窖
窍	竅
窎	窵
窑	窯
窓	窻 䆫 牕 窗
窕	阿
窖	窌
窗	窻 䆫 窓 牕
窜	竄
窝	窩
窥	窺
窦	竇
窩	窝
窪	洼
窭	窶
窮	穷 竆
窯	窰 窑
窰	窯
窱	𰩏
窴	塡
窵	窎
窶	寠 窭
窺	窥
窻	窓 牕 窗
竀	𰩓
竄	窜
竅	窍
竆	窮
竇	窦
竈	灶
竉	𥥅 𰩅 䆔
竊	窃
竒	奇
竖	豎
竚	佇
竜	龍
竝	並 幷 并
竞	競
竢	俟
竪	豎
竱	𫁟
競	誩 竞
竻	𥵚 簕
竿	𣔼
笃	篤
笋	筍
笑	咲
笓	篦
笔	筆
笕	筧
笛	篴
笨	㤒
笺	箋
笼	籠
笾	籩
筆	笔
筍	笋
筏	栰
筑	築
答	荅
筚	篳
筛	篩
筜	簹
筝	箏
筦	管
筧	笕
筭	算
筯	箸
筱	篠
筴	䇲
筹	籌
筼	篔
签	簽
简	簡
箇	個 个
箋	笺 牋
箍	箛
箎	篪
箏	筝
箒	帚
箓	籙
箔	泡
箖	籃
算	筭
箛	箍
箠	捶
管	筦
箦	簀
箧	篋
箨	籜
箩	籮
箪	簞
箫	簫
箴	針 鍼
箸	筯
箹	𰩺
箾	簫
節	节 卩
範	范
築	筑
篋	箧 匧
篑	簣
篓	簍
篔	筼
篘	𥬠
篠	筱
篡	簒
篢	槓 𬕂
篤	笃
篦	笓
篩	簛 筛 簁
篪	箎
篮	籃
篯	籛
篱	籬
篳	筚
篴	笛
篵	𥬈
篸	𥮾
篺	棑
篿	𰩮
簀	箦
簁	簛 篩
簂	𫂆
簌	雝
簍	篓
簒	篡
簕	竻
簖	籪
簛	篩 簁
簜	𰩹
簞	箪
簠	盙
簡	简 耕
簢	𫂃
簣	籄 篑 蕢
簥	𰩸
簨	栒
簫	箾 燒 箫
簵	𰪏
簷	檐
簹	筜
簻	檛 𰩻
簽	签
簾	帘 𢅏 𢅖
籁	籟
籃	箖 篮
籄	簣 蕢
籋	𥬞
籌	筹
籐	藤
籑	䉵 饌
籔	䉤
籙	箓
籚	𰩲
籛	篯
籜	箨
籟	籁
籠	笼
籣	𮆏
籥	龠
籦	𰪊
籩	笾
籪	簖
籫	𬖃
籬	篱
籭	𬕄
籮	箩
籯	𰪣
籲	龥
籴	糴
类	類
籼	秈
粃	秕
粗	麄 觕 麤
粘	黏
粜	糶
粝	糲
粤	粵
粦	㷠 燐
粧	妝
粪	糞
粮	糧
粯	𬖑
粳	稉 秔
粵	粤
粻	𰪭
粽	糉
糁	糝
糇	餱
糉	粽
糓	穀
糕	餻
糖	餹
糙	㿷
糝	糁
糞	粪
糟	醩
糠	穅
糡	糨
糤	饊
糧	粮
糨	糡
糮	𬖮
糯	稬 穤
糰	𰪶 䊜
糲	粝
糴	籴
糶	條 粜
糷	𰫖
糸	糹
糹	糸 纟
糺	糾 𫄙
系	繫 係
糽	𰫼
糾	纠 糺
紀	纪
紂	纣
紃	𬘓
約	约
紅	红
紆	纡
紇	纥
紈	纨
紉	纫
紋	纹
紌	𬘕
納	纳
紐	纽
紑	𰫽
紒	𰬀
紓	纾
純	纯
紕	纰
紖	纼
紗	纱
紘	纮
紙	纸 帋
級	𨸚 级
紛	纷
紜	纭
紝	纴
紞	𬘘
紟	衿 𫄛
紡	纺
紥	紮
紧	緊
紨	𰬅
紩	𮉢
紬	綢 䌷
紭	𰬋
紮	扎 紥
累	纍
細	细
紱	绂
紲	緤 绁
紳	绅
紵	纻
紶	𬘛
紸	𰬇
紹	绍 佋
紺	绀
紼	绋
紽	𰬉
紾	𬘝
紿	绐
絀	绌
絁	𫄟
終	终
絃	𰬈 弦
組	组
絅	䌹 褧
絆	绊
絇	𰬆
絍	𫟃
絎	绗
結	揭 结
絑	𰬏
絓	𮉤
絕	绝 絶
絖	纊 𬘢
絘	𰬒
絙	𫄠 絚
絚	𰬌 縆 緪 絙
絛	绦 縚
絝	褲 袴 绔
絞	绞
絟	𬘥
絠	𬘠
絡	络
絢	绚
絣	背 𰬔
絤	𬘟
絥	𫄢 鞴
給	给
絧	𫄡
絨	绒
絪	𬘡 氤
絯	𰬓
絰	绖
統	綂 统
絲	丝
絳	绛
絶	絕
絷	縶
絸	𬘖
絹	绢
絺	𫄨
絻	𰬜
絼	𰬛
絽	𬘤
絾	𰬖
絿	𰬗
綀	𦈌
綁	绑
綂	統
綃	绡
綄	𬘫
綅	𰬞
綆	绠
綇	𦈋
綈	绨
綉	繡
綊	𰬍
綋	𫟄
綌	绤
綍	𰬘
綎	𬘩
綏	绥
綐	䌼
綑	捆
經	经 𦀇
綕	𬘨
綖	𫄧
綜	综
綝	𬘭
綞	缍
綟	𫄫
綠	氯 绿
綡	𫟅
綢	紬 绸
綣	绻
綧	𬘯
綪	𬘬
綫	線
綬	绶
維	维
綯	绹
綰	绾
綱	纲
網	网
綳	繃
綴	缀
綵	䌽
綷	𮉬
綸	纶
綹	绺
綺	绮
綻	绽 䘺
綼	𰬤
綽	绰
綾	绫
綿	绵 緜
緀	𰬢
緁	𰬡
緂	𰬧
緄	绲
緅	𮉪
緆	𰬣
緇	缁
緉	𮉧
緊	紧 𦂳
緋	绯
緌	𮉫
緍	𦈏
緎	𰬟
総	𰬥
緒	绪
緓	绬
緔	绱
緗	缃
緘	缄
緙	缂
線	綫 缐 线
緛	𬘰
緜	綿
緝	缉
緞	缎
緟	𫟆
締	缔
緡	眠 缗
緢	𰬬
緣	缘 縁
緤	𫄬 紲
緥	褓
緦	缌
緧	𬘶
編	编
緩	缓
緪	絚 縆 𬘵
緫	𰬰
緬	缅
緮	𫄭
緯	纬
緰	𦈕
緱	缑
緲	眇 缈
練	练
緵	𰬯
緶	缏
緷	𦈉
緸	𦈑
緹	缇
緺	𮉨
緻	𰬫 致
縁	緣
縆	絚 緪
縈	萦
縉	缙
縊	缢
縋	缒
縌	𰬳
縍	𫄰
縎	𦈔
縐	绉 皺
縑	缣
縒	𬘷
縓	𰬲
縕	韞 缊
縖	𬘻
縗	缞
縚	絛 𬘺
縛	缚
縜	𰬚
縝	缜
縞	缟
縟	溽 缛
縡	𰬴
縣	县
縧	绦
縩	𮉯
縪	𰬎
縫	缝
縬	𦈚
縭	缡 褵
縮	缩
縯	䌥 𬙂
縰	𫄳
縱	纵
縲	缧
縳	䌸
縴	𰬮
縵	缦
縶	絷
縷	缕
縸	𫄲
縹	缥
縺	𦈐
縼	𰬵
總	摠 总 搃
績	绩
縿	𰬪
繀	𮉮
繂	𫄴
繃	绷 綳
繅	缫 繰
繆	缪
繈	繦 𫄶 襁
繎	𬙇
繏	𦈝
繐	𰬸
繑	𰬐
繒	缯
繓	𦈛
織	织
繕	缮
繖	傘 𰬷
繗	𬙈
繘	𰬻
繙	𬙆
繚	缭
繜	𰬺
繞	绕 遶
繟	𦈎
繡	𰬩 绣 綉
繢	繪 缋
繣	𰬠
繦	繈 襁
繨	𫄤
繩	绳 䋲
繪	繢 绘
繫	系
繬	𫄱
繭	茧
繮	韁 缰
繯	缳
繰	繅 缲
繲	挫 𰬽
繳	缴
繵	𬙉
繶	𫄷
繷	𫄣
繸	䍁
繹	绎
繻	𦈡
繼	继
繽	缤
繾	缱
繿	䍀
纀	𰬿
纁	𫄸
纂	臇 𤎱
纃	𬘧
纆	𬙊
纇	颣
纈	缬
纊	絖 纩
纋	𰭀
續	续
纍	累
纎	纖
纏	缠
纑	𮉡
纓	缨
纔	才
纕	𬙋
纖	纎 纤 砌
纗	𫄹
纘	缵
纚	𫄥
纜	缆 䌫
纟	糹
纠	糾
纡	紆
红	紅
纣	紂
纤	纖
纥	紇
约	約
级	級
纨	紈
纩	纊
纪	紀
纫	紉
纬	緯
纭	紜
纮	紘
纯	純
纰	紕
纱	紗
纲	綱
纳	納
纴	紝
纵	縱
纶	綸
纷	紛
纸	紙
纹	紋
纺	紡
纻	紵
纼	紖
纽	紐
纾	紓
线	線
绀	紺
绁	紲
绂	紱
练	練
组	組
绅	紳
细	細
织	織
终	終
绉	縐
绊	絆
绋	紼
绌	絀
绍	紹
绎	繹
经	經
绐	紿
绑	綁
绒	絨
结	結
绔	絝
绕	繞
绖	絰
绗	絎
绘	繪
给	給
绚	絢
绛	絳
络	絡
绝	絕
绞	絞
统	統
绠	綆
绡	綃
绢	絹
绣	繡
绤	綌
绥	綏
绦	縧 絛
继	繼
绨	綈
绩	績
绪	緒
绫	綾
绬	緓
续	續
绮	綺
绯	緋
绰	綽
绱	鞝 緔
绲	緄
绳	繩
维	維
绵	綿
绶	綬
绷	繃
绸	綢
绹	綯
绺	綹
绻	綣
综	綜
绽	綻
绾	綰
绿	綠
缀	綴
缁	緇
缂	緙
缃	緗
缄	緘
缅	緬
缆	纜
缇	緹
缈	緲
缉	緝
缊	縕
缋	繢
缌	緦
缍	綞
缎	緞
缏	緶
缐	線
缑	緱
缒	縋
缓	緩
缔	締
缕	縷
编	編
缗	緡
缘	緣
缙	縉
缚	縛
缛	縟
缜	縝
缝	縫
缞	縗
缟	縞
缠	纏
缡	縭
缢	縊
缣	縑
缤	繽
缥	縹
缦	縵
缧	縲
缨	纓
缩	縮
缪	繆
缫	繅
缬	纈
缭	繚
缮	繕
缯	繒
缰	繮 韁
缱	繾
缲	繰
缳	繯
缴	繳
缵	纘
缶	缻
缸	堈 罁
缻	缶
缽	鉢 钵
缾	瓶
罁	堈 缸
罂	罌
罃	罌 甖
罅	𨻲
罆	𰭄
罇	樽 墫
罈	壜 坛 墰
罋	甕 瓮
罌	罂 罃 甖
罏	𬙎
罐	礶
网	罔 㓁 網
罔	网
罗	羅
罚	罰
罢	罷
罩	䈇
罪	辠
置	寘
罰	罚
署	穎
罴	羆
罵	骂 傌
罷	罢
罼	𬙝
羁	羈
羂	𰭔
羃	冪
羅	罗
羆	罴
羈	羁 覊
羋	芈
羌	羗
美	羙
羓	豝
羖	𦍩
羗	羌
羙	美
羟	羥
羡	羨
羣	群
群	羣
羥	羟
羨	羡
義	义
羮	羹
羴	羶
羵	𫅗
羶	膻 羴
羹	羮
翄	翅
翅	翄
習	习
翘	翹
翙	翽
翚	翬
翜	𰭢
翥	䬡
翦	剪
翬	翚
翱	翺
翹	翘
翺	翱
翼	折
翽	翙
翿	𰭣
耀	燿 曜
考	攷
耏	耐
耐	耏
耑	專
耒	來
耔	秄
耕	簡 畊
耗	秏
耘	秐
耙	鈀
耢	耮
耤	藉
耧	耬
耨	鎒
耬	耧
耮	耢
耰	櫌
耸	聳
耻	恥
耼	聃
聂	聶
聃	耼
聋	聾
职	職
聍	聹
联	聯
聖	圣
聝	馘
聞	闻
聦	聰
聩	聵
聪	聰
聯	联
聰	聪 聦
聲	声
聳	耸
聵	聩
聶	聂
職	职 軄
聹	聍
聻	魙 𫆏
聽	听
聾	聋
肃	肅
肅	肃
肆	四
肇	肈
肈	肇
肐	𩨘 胳
肕	韌
肠	腸
股	𦙶
肢	胑
肤	膚
肦	朌
肧	胚
肨	胮
肬	疣
肮	骯
肱	厷
育	毓
肳	吻
肴	餚 肴
肾	腎
肿	腫
胀	脹
胁	脅
胄	伷 冑
胆	膽
胊	朐
背	絣
胐	朏
胑	肢
胓	𦚓
胔	骴
胗	疹
胚	肧
胜	勝
胡	衚 鬍
胧	朧
胨	腖
胪	臚
胫	脛
胭	臙
胮	肨
胯	骻
胳	𩨘 肐
胶	膠 㬵
胷	匈 胸
胸	匈 胷
胼	腁
脁	朓
脃	脆
脅	胁 脇 勰
脆	脃
脇	脅
脈	衇 脉
脉	衇 䘑 脈
脍	膾
脏	臟 髒
脐	臍
脑	腦
脓	膿
脔	臠
脚	腳
脛	胫
脣	唇
脥	𣍰
脧	朘
脪	㾙
脫	脱
脱	脫
脶	腡
脸	臉
脹	胀 痮
脼	𣍷
腁	胼
腊	臈 臘
腌	骯
腎	肾
腕	𦙵
腖	胨
腘	膕
腡	脶
腢	髃
腦	脑 匘
腪	𣍯
腫	尰 肿
腭	齶
腮	顋
腳	脚
腸	肠
腻	膩
腼	靦
腽	膃
腾	騰
腿	骽
膃	腽
膆	嗉
膋	膫
膑	臏
膒	𬁵
膕	腘
膚	肤
膞	䏝
膠	胶
膢	𦝼
膧	朣
膩	腻
膫	膋
膮	𰮝
膳	饍
膴	𰮇
膶	𬂀
膷	𰮅
膹	𪱥
膻	羶
膽	胆
膾	鱠 脍
膿	脓
臇	䐪 纂 𤎱
臈	腊 臘
臉	脸
臊	𦞣
臍	脐
臏	膑 髕
臗	𣎑
臘	臈 腊
臙	胭
臚	胪
臜	臢
臞	癯
臟	脏
臠	脔
臡	𰯋
臢	臜
臥	卧
臨	临
臯	皋
致	緻 致
臺	台
舀	外 抌
舆	輿
與	与
興	㒷 兴
舉	㪯 举 擧
舊	旧
舍	捨
舐	舓
舒	摴
舓	舐
舔	餂
舖	鋪
舘	館
舡	船
舣	艤
舦	艜
舰	艦
舱	艙
舵	柁
船	舡
舻	艫
艑	扁
艙	舱
艛	𰰑
艜	𰰏 舦
艢	檣
艤	舣
艥	楫 檝
艦	舰
艪	櫓 樐
艫	舻
艭	𰰋
艰	艱
艱	艰
艳	艷
艶	豓 豔
艷	艳
艸	艹 草
艹	草 艸
艺	藝
节	節
芈	羋
芒	杧
芔	卉
芗	薌
芜	蕪
芟	𠚹
芦	蘆
花	蘤
芸	蕓
芻	刍 𦷝 蒭
苁	蓯
苇	葦
苈	藶
苋	莧
苌	萇
苍	蒼
苎	苧
苏	蘇
苕	䒒
苛	哼
苟	茍
苡	苢
苢	苡
苤	瞥
苧	苎 薴
苹	蘋
苺	莓
苿	茉
范	範
茉	苿
茍	苟
茎	莖
茏	蘢
茑	蔦
茔	塋
茕	煢
茠	薅
茧	繭
茲	玆 兹
荅	答
荆	荊
荇	莕
草	艹 艸
荊	荆
荍	蕎
荐	薦
荔	栛
荙	薘
荚	莢
荛	蕘
荜	蓽
荝	萴
荞	蕎
荟	薈
荠	薺
荡	蕩 盪
荣	榮
荤	葷
荥	滎
荦	犖
荧	熒
荨	蕁
荩	藎
荪	蓀
荫	蔭
荬	蕒
荭	葒
荮	葤
药	藥
荳	豆
莀	農
莅	涖 蒞
莊	庄
莓	苺
莕	荇
莖	茎
莜	蓧
莢	荚
莧	苋
莩	殍
莱	萊
莲	蓮
莳	蒔
莴	萵
莶	薟
获	穫 獲
莸	蕕
莹	瑩
莺	鶯
莼	蓴
莿	刺 朿
菇	菰
菌	滾 蕈
菑	烖 灾 災 甾
菓	果
菔	蔔
菕	𰰨
菢	勽
菫	堇
華	华 崋 蕐
菰	菇
菴	庵
菸	煙 烟
萆	蓖
萇	苌
萊	莱
萚	蘀
萝	蘿
萤	螢
营	營
萦	縈
萧	蕭
萨	薩
萬	卍 万
萯	𰰷
萱	萲
萲	萱
萴	荝
萵	莴
葁	薑
葉	叶
葒	荭
著	螫 着
葚	椹
葝	𫈎
葢	盖 蓋
葤	荮
葦	苇
葬	塟
葯	藥
葱	蔥
葷	荤
葻	𬜥
蒇	蕆
蒉	蕢
蒋	蔣
蒌	蔞
蒍	蔿 𫇭
蒒	𰰳
蒓	蓴
蒔	莳
蒞	涖 莅
蒭	芻 𫇴
蒳	𰱌
蒶	𰱍
蒸	烝
蒼	苍
蓀	荪
蓋	盖 葢
蓖	萆
蓝	藍
蓟	薊
蓠	蘺
蓣	蕷
蓥	鎣
蓦	驀
蓧	莜
蓮	莲
蓯	苁
蓲	𰰤
蓴	莼 蒓
蓺	埶 秇 藝
蓽	荜
蔂	虆
蔄	𬜬
蔎	𰰺
蔔	菔
蔗	𧀹
蔚	嶎
蔞	褸 蒌
蔠	𰱛
蔣	蒋
蔥	葱
蔦	茑
蔪	𰱑
蔭	荫 廕
蔮	𬜿
蔯	𫈟
蔱	𰰵
蔴	麻
蔷	薔
蔹	蘞
蔺	藺
蔼	藹
蔿	蒍
蕁	荨
蕄	𰱉
蕆	蒇
蕈	菌
蕊	蕋
蕋	蕊
蕎	荞 荍
蕐	華
蕑	𰱇
蕒	荬
蕓	芸
蕕	莸
蕘	荛
蕝	𫈵
蕟	𬜧
蕡	𰱟
蕢	籄 簣 蒉
蕣	橓
蕤	甤
蕧	𰱦
蕩	盪 偒 荡 蘯
蕪	芜
蕭	萧
蕰	薀
蕲	蘄
蕳	𫈉
蕴	蘊
蕷	蓣
蕽	𫇽
薀	蕰
薅	茠
薆	𫉁
薈	荟
薉	𬜨
薊	蓟
薋	𰱱
薌	芗
薑	葁
薓	參
薔	蔷
薖	𰰾
薘	荙
薟	莶 蘞
薠	𮐚
薦	荐
薩	萨
薮	藪
薯	藷
薱	𰰱
薲	𬝯
薳	䓕
薴	苧
薵	䓓
薺	荠
藇	𰰠 𨣦
藉	耤
藍	蓝
藎	荩
藓	蘚
藖	𬜾
藘	𰱮
藚	𰱐
藝	埶 蓺 秇 艺
藟	蘽
藣	𰱯
藤	籐
藥	葯 药
藦	蘑
藪	薮
藬	𬞘
藰	𰰹
藶	苈
藷	薯 𫉄
藹	蔼
藺	蔺
藾	𰱾
蘀	萚
蘄	蕲
蘆	芦
蘇	苏
蘈	𰲁
蘊	蕴
蘋	苹 𬞟
蘑	藦
蘖	櫱
蘚	藓
蘞	薟 蔹
蘟	𦻕
蘡	𮐨
蘢	茏
蘤	花
蘫	𬞫
蘬	𰰮
蘭	兰 𬞕
蘯	蕩 盪
蘱	𰲒
蘵	𰱲
蘷	虁
蘹	𬜸
蘺	蓠
蘽	藟
蘿	萝
虁	蘷
虅	𰲂
虆	蔂
虉	𬟁
虏	虜
虐	䖈
虑	慮
虓	猇 唬
虔	䖍
處	処 䖏 处
虚	虛
虛	虚
虜	虏 擄
虞	𩦢
號	号
虣	暴
虦	𰲠
虧	亏
虫	蟲
虬	虯 蚪
虮	蟣
虯	虬
虱	蝨
虽	雖
虾	蝦
虿	蠆
蚀	蝕
蚁	蟻
蚂	螞
蚃	蠁
蚊	蟁
蚋	蜹
蚓	螾
蚕	蠶
蚘	痐 蛕 蛔
蚝	螆
蚤	䖣
蚦	蚺
蚪	虬
蚬	蜆
蚺	蚦
蛄	蛌
蛆	𧐅
蛊	蠱
蛋	蜑
蛌	蛄
蛎	蠣
蛏	蟶
蛓	螆
蛔	蛕 蚘
蛕	蛔 蚘
蛗	𧌓
蛙	鼃
蛛	鼄
蛮	蠻
蛰	蟄
蛱	蛺
蛲	蟯
蛳	螄
蛴	蠐
蛵	𰲶
蛺	蛱
蛻	蜕
蛼	𰲬
蜂	蠭
蜆	蚬
蜇	𧋍
蜋	螂
蜍	蠩
蜑	蛋
蜕	蛻
蜗	蝸
蜝	蜞
蜞	蜝
蜡	蠟 䄍 蜡
蜦	𰲰
蜨	蝶
蜫	䖵
蜶	蟀
蜸	𰲮
蜹	蚋
蜽	𮔊
蝀	𬟽
蝁	𰲸
蝃	螮
蝇	蠅
蝈	蟈
蝉	蟬
蝎	蠍
蝕	蚀
蝜	𮔅
蝟	猬
蝥	蟊
蝦	虾 鰕
蝨	虱
蝯	猿 猨
蝱	䖟
蝶	蜨
蝸	蜗
蝼	螻
蝾	蠑
螀	螿
螂	蜋
螄	蛳
螆	蚝 蛓
融	螎
螎	融
螗	螳
螘	蟻 𰲹
螙	蠧
螞	蚂
螢	萤
螨	蟎
螫	著
螮	䗖 蝃
螳	螗
螴	𰳄
螹	𰳂
螺	蠃
螻	蝼
螾	蚓
螿	螀
蟀	蜶
蟁	蚊
蟂	𫋇
蟄	蛰
蟈	蝈
蟊	蝥
蟎	螨
蟏	蠨
蟘	𫋌
蟚	蟛
蟛	蟚
蟜	𫊸
蟡	𰲲
蟣	虮
蟦	𰳊
蟬	蝉
蟮	蟺
蟯	蛲
蟱	𰲫
蟲	虫
蟳	𫊻
蟶	蛏
蟷	𬠅
蟹	蠏
蟺	蟮
蟻	蚁 螘
蟽	𰲻
蠀	𧏗
蠁	蚃
蠃	螺
蠅	蝇
蠆	虿
蠈	𬠠
蠌	𰲵
蠍	蝎
蠏	蟹
蠐	蛴
蠑	蝾
蠒	𫊱
蠔	𧐢
蠙	𧏖
蠞	𬝋
蠟	蜡
蠣	蛎
蠦	𫊮
蠧	螙
蠨	蟏
蠩	蜍
蠪	𰲴
蠭	蜂
蠱	蛊
蠳	𰳗
蠶	蚕
蠻	蛮
蠾	𧑏
衂	衄
衄	衂
衅	釁
衆	𠂝 眾
衇	脉 脈
衒	炫
術	术
衔	銜
衕	同
衚	胡
衛	卫 衞
衝	冲 𧘂
衞	衛
衣	衤
衤	衣
补	補
表	表 錶
衬	襯
衮	袞
衽	袵
衿	紟 襟
袄	襖
袅	裊
袆	褘
袋	帒
袒	襢
袜	襪
袞	衮
袠	帙
袭	襲
袮	您 妳 你 祢
袯	襏
袴	絝 褲
袵	衽
袷	裌
装	裝
裆	襠
裈	褌
裉	褃
裊	袅
裌	袷 𬡒
裏	裡
裒	鴄
裙	帬 裠
補	补
裝	装
裠	裙
裡	里 裏
裢	褳
裣	襝
裤	褲
裥	襇
裲	𮖁
裸	躶
製	制
褃	裉
複	复
褌	裈
褎	褏
褏	褎
褒	襃
褓	緥
褘	袆
褛	褸
褝	襌
褟	溻
褢	褱
褧	絅
褭	𬡇
褱	褢
褲	絝 袴 裤
褳	裢
褴	襤
褵	縭
褸	褛 蔞
褺	𬡓 䙝 褻
褻	䙝 亵 褺
襀	𫌀
襁	繦 繈
襂	𰴂
襃	褒
襄	㐮
襇	裥
襌	褝
襍	雜
襏	袯
襓	𫋹
襕	襴
襖	澳 袄 𥜌
襗	𫋷
襘	𫋻
襛	𰳺
襜	輦 襝
襝	襜 裣
襟	衿
襠	裆
襢	袒
襤	褴
襨	𰳸
襪	袜 韈 韤
襬	䙓
襭	𮖱
襮	幞
襯	衬 儭
襰	𧝝
襱	𰳲
襲	袭
襴	襕
襵	𫌇
襸	𬡷
襹	𰳼
襼	𰳵
覆	复
覇	霸
覊	羈
見	见
覌	觀
覎	觃
規	规
覐	覺
覒	𬆾
覓	觅 覔
覔	覓
覕	𰴕
視	视 眎
覗	𬢊
覘	觇 䦓 𦕒
覛	𫌪
覜	𬢋
覟	𬢌
覠	𰴙
覡	觋
覢	𬊦
覤	𬟪
覥	靦 觍
覦	觎
覩	睹 𬢎
親	亲
覬	觊
覭	𬢒
覯	觏
覰	覷 𰴜
覲	觐
覴	𬢔
覶	𰴝
覷	觑 覰
覸	𰴘
覹	𫌭
覺	觉 覐 斍
覻	𰴞
覼	𫌨
覽	览
覿	觌
觀	覌 观
见	見
观	觀
觃	覎
规	規
觅	覓
视	視
觇	覘
览	覽
觉	覺
觊	覬
觋	覡
觌	覿
觍	覥
觎	覦
觏	覯
觐	覲
觑	覷
觔	斤
觕	麄 麤 粗
觜	咀 嘴
觝	牴
觞	觴
解	觧
觥	觵
触	觸
觧	解
觯	觶
觴	觞
觵	觥
觶	觯
觷	𰴣
觸	触
觹	𧤤
觻	𰴢
觽	𧥅
訁	讠
訂	订
訃	讣
訆	𰵊
訇	𢕐 渹
計	计
訊	讯
訌	讧
討	讨
訏	𬣙
訐	讦
訑	𫍙
訒	讱
訓	训
訕	讪
訖	讫
託	讬 侂
記	记
訚	誾
訛	譌 讹
訜	𫍛
訝	讶
訞	䚶 𫍚
訟	讼
訠	矧
訢	䜣
訣	诀
訥	讷 吶
訦	𰵒 諶
訧	𰵎
訨	𫟞
訩	詾 讻
訪	访
訬	𰵏
設	设
訮	詽
訰	𰵍
許	许
訴	愬 诉
訶	诃
訸	𰵝
訹	𰵓
診	诊
註	注 𬣣
証	證
訽	詬 𰵛
詀	𧮪
詁	诂
詃	𬣤
詄	𰵙
詅	𰵚
詆	诋
詇	𰵗
詉	𰵠
詊	𫟟
詋	呪
詌	𬣠
詍	𰵔
詎	讵
詏	𬣦
詐	诈 醡
詑	𫍡
詒	诒
詓	𫍜
詔	诏
評	评
詖	诐
詗	诇
詘	诎
詛	诅
詜	𬣥
詝	𬣞
詞	词
詟	讋
詠	咏 𰵞
詡	诩
詢	询
詣	诣
詤	謊
詥	𰵣
試	试
詧	察
詨	𰵦
詩	诗
詪	𬣳
詫	诧
詬	訽 呴 诟
詭	诡
詮	诠
詯	𬣰
詰	诘
話	话 䛡
該	该
詳	详
詴	𬣩
詵	侁 诜 駪
詶	𬣱
詷	𫍣
詺	𬣮
詻	𰵤
詼	诙
詽	訮
詾	訩
詿	诖
誂	𫍥
誃	𰵥
誄	诔
誅	诛
誆	诓
誇	夸
誉	譽
誊	謄
誋	𫍪
誌	𰵧 志
認	认
誎	𬣷
誏	𬣼
誐	𰵮 哦
誑	诳
誒	诶
誔	𬣻
誕	𧩙 诞
誗	𰵭
誘	䛻 诱
誙	𰵡
誚	诮 譙
誜	𰵯
語	语
誠	诚
誡	诫
誣	诬
誤	误 悞
誥	诰
誦	诵
誧	𰵩
誨	诲
誩	競
說	説 说
誫	𫍨
説	說
誰	谁
課	课
誳	𫍮
誴	𫟡
誶	谇
誷	𫍬
誹	诽
誺	𫍧
誻	𰵸
誼	谊
誽	𰵵
誾	訚
調	调
諁	啜 𰵷
諂	谄
諃	𰵱
諄	谆
諆	𰵲
談	譚 谈
諈	𰵶
諉	诿 餵
諊	鞫
請	请
諍	诤
諎	𬣾
諏	诹
諑	诼
諒	谅
諓	𬣡
諔	𰵴
諕	𬤀 唬
論	论
諗	谂
諛	谀
諜	谍
諝	谞
諞	谝
諟	𬤊
諠	𬤎 喧
諡	謚
諢	诨
諣	𫍩
諤	谔 囮 讍
諥	𫍳
諦	谛
諧	龤 谐
諩	𬣲
諫	谏
諭	谕
諮	谘 咨 嗞
諯	𫍱
諰	𫍰
諱	讳
諲	𬤇
諳	谙
諴	𫍯
諵	喃
諶	谌 訦
諷	讽
諸	诸
諹	𰵌
諺	谚
諻	𬤍
諼	谖 煖
諾	诺
謀	谋
謁	谒
謂	谓
謄	誊
謅	诌
謆	𫍸
謉	𫍷
謊	谎 詤
謋	𰵼
謌	歌 𬤐
謍	𰴯
謎	谜
謏	𫍲
謐	谧
謑	𰵾
謔	谑
謖	谡
謗	谤
謙	谦
謚	諡 谥
講	讲
謜	𰵺
謝	谢
謞	𰵿
謟	𰵽
謠	谣
謣	𰶀
謥	𰶂
謨	谟
謫	讁 谪
謬	谬
謭	谫
謯	𫍹
謰	𬣽
謱	𫍴 嘍
謲	𬢳 𬤄
謳	讴
謴	𬤆
謵	𰶃
謸	𫍵
謹	谨
謻	𰶁
謼	𬤙
謾	谩
譀	𰶆
譁	嘩
譂	𫟠
譄	𬤤
譅	𰶎
譆	𫍻
譇	𰶄
譈	憝 𬤣 懟
證	证 証
譊	𫍢
譌	訛 𰵑
譎	憰 谲
譏	讥
譐	𬤢 噂
譑	𫍤
譓	𬤝
譔	𬤥
譖	谮
識	识
譙	誚 谯
譚	谭 談
譜	谱
譞	𫍽
譟	噪 𬤨
譠	𰶉
譡	𬣭
警	儆
譨	𫍦
譩	𰶊
譫	谵
譭	䛼
譯	译
議	议
譳	𰶌
譴	谴
護	护
譸	诪 𬢪
譹	𬤫
譺	𬤩
譻	𬢯
譼	䛓
譽	誉 域
譾	谫 𫍿
譿	𬤭
讀	读
讁	謫
讂	𰶍
讅	谉
讆	𬣀 讏
讇	𬤛
讉	𬤦
變	変 变
讋	詟
讌	䜩 宴
讍	諤
讎	讐 雠 仇
讏	讆
讐	讎 仇
讑	𰶏
讒	谗
讓	让
讔	𮙊
讕	谰
讖	谶
讘	囁 𰵹
讙	𬤰
讚	𬤮
讛	𰵖
讜	谠
讝	𰵨
讞	谳
讟	𮙋
讠	訁
计	計
订	訂
讣	訃
认	認
讥	譏
讦	訐
讧	訌
讨	討
让	讓
讪	訕
讫	訖
讬	託
训	訓
议	議
讯	訊
记	記
讱	訒
讲	講
讳	諱
讴	謳
讵	詎
讶	訝
讷	訥
许	許
讹	訛
论	論
讻	訩
讼	訟
讽	諷
设	設
访	訪
诀	訣
证	證
诂	詁
诃	訶
评	評
诅	詛
识	識
诇	詗
诈	詐
诉	訴
诊	診
诋	詆
诌	謅
词	詞
诎	詘
诏	詔
诐	詖
译	譯
诒	詒
诓	誆
诔	誄
试	試
诖	詿
诗	詩
诘	詰
诙	詼
诚	誠
诛	誅
诜	詵
话	話
诞	誕
诟	詬
诠	詮
诡	詭
询	詢
诣	詣
诤	諍
该	該
详	詳
诧	詫
诨	諢
诩	詡
诪	譸
诫	誡
诬	誣
语	語
诮	誚
误	誤
诰	誥
诱	誘
诲	誨
诳	誑
说	說
诵	誦
诶	誒
请	請
诸	諸
诹	諏
诺	諾
读	讀
诼	諑
诽	誹
课	課
诿	諉
谀	諛
谁	誰
谂	諗
调	調
谄	諂
谅	諒
谆	諄
谇	誶
谈	談
谉	讅
谊	誼
谋	謀
谌	諶
谍	諜
谎	謊
谏	諫
谐	諧
谑	謔
谒	謁
谓	謂
谔	諤
谕	諭
谖	諼
谗	讒
谘	諮
谙	諳
谚	諺
谛	諦
谜	謎
谝	諞
谞	諝
谟	謨
谠	讜
谡	謖
谢	謝
谣	謠
谤	謗
谥	謚
谦	謙
谧	謐
谨	謹
谩	謾
谪	謫
谫	謭 譾
谬	謬
谭	譚
谮	譖
谯	譙
谰	讕
谱	譜
谲	譎
谳	讞
谴	譴
谵	譫
谶	讖
谷	穀
谿	嵠
豄	𰶔
豅	𰶑
豆	荳
豇	䜶
豈	岂
豋	登
豎	竖 竪
豐	丰
豓	豔 艶
豔	豓 艶
豘	豚
豚	豘
豜	豣
豝	羓
豣	豜
豫	預
豬	猪
豮	豶
豳	邠 㟗
豴	蹢
豵	𫎆 䝋
豶	豮
豸	廌
豺	犲
豻	犴
貌	皃
貍	狸
貎	皃
貓	猫
貗	𫎌
貙	䝙
貛	獾
貝	贝
貞	贞
貟	贠
負	负
財	财 才 㒲
貢	贡
貣	𰷞
貤	𰷠
貦	𰷡
貧	贫
貨	货
販	𧶶 贩
貪	贪
貫	贯
責	拆 责
貭	質
貯	贮
貰	贳
貱	𬥶
貲	赀
貳	弍 贰 二
貴	贵
貶	贬
買	𧹒 买
貸	贷
貺	贶
費	费
貼	贴
貽	贻
貾	𰷢
貿	贸
賀	贺
賁	贲
賂	赂
賃	赁
賄	贿
賅	侅 赅
資	资
賈	贾
賊	贼
賍	贜 贓
賑	赈
賒	赊
賓	宾 賔
賔	賓
賕	赇
賗	𬥸
賙	赒
賚	赉
賛	贊
賜	赐
賝	𫎩
賞	赏
賟	𧹖
賠	赔
賡	赓
賢	贤 贒
賣	卖
賤	贱
賥	𰷤
賦	赋
賧	赕
賨	𰷥
質	质 貭
賫	齎
賬	帳 账 𧹔
賭	赌
賮	贐 𰷧
賰	䞐
賴	頼 赖
賵	赗
賶	𬥳
賸	𬂉 剩
賹	𰷪
賺	赚 𧸖 贃
賻	赙
購	购
賽	赛
賾	赜
贃	賺 𧹗 𧸖
贄	贽
贅	赘
贆	𰷫
贇	赟
贈	赠
贉	𫎫
贊	賛 赞
贋	赝 贗 偐
贍	赡
贏	赢
贐	赆 賮
贑	𫎬
贒	賢
贓	贜 賍 𰷭 赃
贔	赑
贕	𫧿
贖	赎
贗	赝 贋 偐
贙	𰷮
贚	𫎦
贛	赣
贜	賍 贓
贝	貝
贞	貞
负	負
贠	貟
贡	貢
财	財
责	責
贤	賢
败	敗
账	賬
货	貨
质	質
贩	販
贪	貪
贫	貧
贬	貶
购	購
贮	貯
贯	貫
贰	貳
贱	賤
贲	賁
贳	貰
贴	貼
贵	貴
贶	貺
贷	貸
贸	貿
费	費
贺	賀
贻	貽
贼	賊
贽	贄
贾	賈
贿	賄
赀	貲
赁	賃
赂	賂
赃	贓
资	資
赅	賅
赆	贐
赇	賕
赈	賑
赉	賚
赊	賒
赋	賦
赌	賭
赍	齎
赎	贖
赏	賞
赐	賜
赑	贔
赒	賙
赓	賡
赔	賠
赕	賧
赖	賴
赗	賵
赘	贅
赙	賻
赚	賺
赛	賽
赜	賾
赝	贗 贋
赞	贊
赟	贇
赠	贈
赡	贍
赢	贏
赣	贛
赤	𤆍
赪	赬
赬	䞓 赪
赵	趙
赶	趕
赿	趆
趁	趂
趂	趁
趄	跙
趆	赿
趋	趨
趒	跳
趕	赶
趙	赵
趨	趋
趫	𰷶
趬	𰷵
趮	躁
趯	躍
趱	趲
趲	趱
趸	躉
跃	躍
跄	蹌
跊	𧿴
跐	跴
跖	蹠
跙	趄
跞	躒
跡	速 迹 蹟
跥	跺
跳	趒
跴	踹 跐
践	踐
跶	躂
跷	蹺
跸	蹕
跹	躚
跺	跥
跻	躋
踁	硜
踊	踴
踌	躊
踏	蹋
踐	践
踚	𬦧
踦	犄
踪	蹤
踬	躓
踭	㬹
踯	躑
踰	逾
踴	踊
踵	歱
踹	跴
踽	偊
蹄	蹏
蹋	踏 蹹
蹌	跄 牄
蹏	蹄
蹑	躡
蹒	蹣
蹔	𫏐
蹕	跸
蹛	𰸚
蹝	躧 屣
蹟	速 迹 跡
蹠	跖
蹡	𬧀
蹢	豴
蹣	蹒
蹤	𧿛 踪
蹥	𰸔
蹧	遭
蹪	𰸞
蹭	矰
蹮	躚
蹰	躕
蹳	𫏆
蹴	蹵
蹵	蹴
蹶	蹷
蹷	蹶
蹹	蹋
蹺	蹻 跷
蹻	蹺 𫏋
蹿	躥
躀	𬦻
躁	趮
躂	跶
躅	䠱
躉	趸
躊	踌
躋	隮 跻
躍	趯 跃
躎	䟢
躏	躪
躑	踯
躒	跞
躓	踬
躕	蹰
躗	躛
躘	𨀁
躚	跹 蹮
躛	躗
躜	躦
躝	𨅬
躡	蹑
躥	蹿
躦	躜
躧	𰸐 屣 蹝
躪	躏
躬	躳
躭	眈
躯	軀
躱	躲
躲	躱
躳	躬
躶	裸
躷	矮
軀	躯
軂	𬧤
軃	𰹀
軄	職
軆	体
軇	𮜶
軉	𨉗
車	车
軋	轧
軌	轨
軍	军
軎	𰹲
軏	𫐄
軑	轪
軒	轩
軓	𰹴
軔	轫
軕	𫐅
軖	𰹶
軗	𨐅
軘	𰹸
軛	轭
軜	𫐇
軝	𬨂
軞	𬨁
軟	软 輭
軤	轷
軥	𰺁
軧	𰺀
軨	𫐉
軫	轸
軬	𫐊
軮	𬨄
軯	𰹽
軰	輩
軱	𮝴
軲	轂 轱
軳	𰺂
軵	𰹿
軷	𫐈
軸	轴
軹	轵
軺	轺 𨍳
軻	轲
軼	轶
軾	轼
軿	輧 𫐌
輀	𮝵
輁	𰺄
輂	𰺅
較	较
輄	𨐈
輅	辂
輆	𬨇
輇	辁
輈	辀
載	载 儎
輊	轾
輋	𪨶
輐	𰺇
輑	𰺈
輒	辄 輙
輓	𬨈 挽
輔	辅
輕	轻
輖	𫐏
輗	𫐐
輘	𰺊
輙	輒 𰺋
輚	𰹼
輛	辆
輜	辎
輝	煇 辉
輞	辋
輟	辍
輠	𰺍
輡	𰺐
輢	𫐎
輣	𰺏
輤	𰺉
輥	辊
輦	襜 辇
輧	軿
輨	𫐑
輩	辈 軰
輪	轮
輫	𰺎
輬	辌
輭	軟
輮	𫐓
輯	辑
輲	𰺒
輳	辏
輴	𮝸
輵	𬨍 轕
輶	𬨎
輷	𫐒
輸	输
輹	𰺓
輻	辐
輾	辗
輿	舆 轝
轀	辒
轂	軲 毂
轃	𰺖
轄	辖 鎋
轅	辕
轆	辘 樚
轇	𫐖
轈	𬨓
轉	转
轊	𫐕
轍	辙
轎	轿
轏	𰺞
轐	𫐗
轑	𰺛
轒	𮝷
轓	𰺜
轔	辚
轕	𮝺 輵
轖	𰺙
轗	𫐘 㙳
轘	𮝹
轙	𰹵
轚	𰺟
轛	𰺃
轝	輿 𬛼
轞	𰺗
轟	轰
轠	𫐙
轡	辔
轢	轹
轣	𫐆
轤	轳
轥	𰺣
车	車
轧	軋
轨	軌
轩	軒
轪	軑
轫	軔
转	轉
轭	軛
轮	輪
软	軟
轰	轟
轱	軲
轲	軻
轳	轤
轴	軸
轵	軹
轶	軼
轷	軤
轸	軫
轹	轢
轺	軺
轻	輕
轼	軾
载	載
轾	輊
轿	轎
辀	輈
辁	輇
辂	輅
较	較
辄	輒
辅	輔
辆	輛
辇	輦
辈	輩
辉	輝
辊	輥
辋	輞
辌	輬
辍	輟
辎	輜
辏	輳
辐	輻
辑	輯
辒	轀
输	輸
辔	轡
辕	轅
辖	轄
辗	輾
辘	轆
辙	轍
辚	轔
辞	辤 辭
辟	辟 闢
辠	罪
辢	辣
辣	辢
辤	辭 辞
辦	办
辨	辯
辩	辯
辫	辮
辭	辤 辞
辮	辫
辯	辩 辨
農	农 莀
辵	辶
辶	辵
边	邊
辽	遼
达	達
迁	遷
迆	迤
过	過
迈	邁
迊	匝 帀
运	運
迕	忤
还	還
这	這
进	進
远	遠
违	違
连	連
迟	遲
迤	迆
迨	逮
迩	邇
迪	廸
迫	廹
迯	逃
迳	逕
迴	廻
迹	速 蹟 跡
迺	乃 廼
迻	移
适	適
逃	迯
选	選
逊	遜
递	遞
逓	遞
逕	迳
逖	逷
這	这
逞	期
速	跡
連	连
逦	邐
逮	迨
週	周
進	进
逷	逖
逻	邏
逼	偪
逾	踰
逿	盪 𨌩 𰺲
運	运
遍	徧
過	过
達	达
違	违
遗	遺
遙	遥
遜	愻 逊
遞	递 逓
遠	远
遡	溯 泝
遥	遙
適	适
遭	蹧
遰	𰻆
遱	𫐷
遲	迟
遶	繞 𰺷
遷	迁
選	选
遺	遗
遼	辽
邁	迈
還	还
邅	㣶
邇	迩
邊	边
邏	逻
邐	逦
邓	鄧
邕	𪪝 雍
邝	鄺
邠	豳 㟗
邨	村
邬	鄔
邮	郵
邹	鄒
邺	鄴
邻	鄰
郁	鬱 喐
郄	郤
郎	郞
郏	郟
郐	鄶
郑	鄭
郓	鄆
郞	郎
郟	郏
郤	郄
郦	酈
郧	鄖
郰	鄹
郲	𬩾
郵	邮
郷	鄉 鄕
郸	鄲
鄆	郓
鄉	鄕 郷 乡
鄒	邹
鄔	塢 邬
鄕	鄉 郷
鄖	郧
鄟	𫑘
鄡	𰻮
鄦	𰻡
鄧	邓
鄩	𬩽
鄪	𰻳
鄬	𰻦
鄭	郑
鄮	𬪍
鄰	邻 隣
鄲	郸
鄳	𫑡
鄴	邺
鄶	郐
鄹	郰
鄺	邝
酂	酇
酇	酂
酈	郦
酉	酋
酋	酉
酖	鴆
酝	醞
酢	榨
酦	醱
酧	醻 酬
酬	酧 醻
酱	醬
酹	儡
酽	釅
酾	釃
酿	釀
醃	腌
醆	𬪨
醇	䣩
醊	餟
醑	湑
醒	惺
醜	丑
醞	酝
醡	榨 詐
醦	𮠳
醧	𬪧
醩	糟
醫	医
醬	酱
醱	酦
醲	𬪩
醳	𰼅
醶	𫑷
醻	酧 酬
釀	酿
釁	衅
釃	酾
釅	酽
采	採 埰
释	釋
釋	释
里	裡
野	埜
釐	厘
金	釒
釒	金 钅
釓	钆
釔	钇
釕	钌
釗	钊
釘	钉
釙	钋
釚	𫟲
釛	𰽖
針	箴 针 鍼
釟	𫓥
釣	钓
釤	钐
釥	𰽛
釦	𬬪
釧	钏
釨	𫓦
釩	钒
釪	𰽗
釫	𬬨
釬	𬬧 銲
釭	𮣲
釱	𰽘
釲	𫟳
釳	𨰿
釴	𬬩
釵	钗 叉
釷	钍
釹	钕
釺	钎
釽	𬬲
釾	䥺
釿	𬬱
鈀	钯 耙
鈁	钫
鈂	𬬵
鈃	钘
鈄	钭
鈆	鉛 𫓪
鈇	𫓧
鈈	钚
鈉	钠
鈋	𨱂
鈍	钝
鈎	鉤 钩
鈏	𰽣
鈐	钤
鈑	钣
鈒	钑
鈓	𬬯
鈔	钞
鈕	钮
鈖	𫟴
鈗	𫟵
鈚	𬬫
鈛	𫓨
鈜	𮣳
鈞	钧 銁
鈠	𨱁
鈣	钙
鈤	𰽡
鈥	钬
鈦	钛
鈧	钪
鈪	𰽞
鈮	铌
鈯	𨱄
鈰	铈
鈲	𨱃
鈳	钶
鈴	铃
鈵	𰽥
鈶	𬭀
鈷	钴
鈸	钹
鈹	铍
鈺	钰
鈼	𬬽
鈽	钸
鈾	铀
鈿	钿
鉀	钾
鉁	𨱅
鉄	銕 鐵
鉅	钜
鉆	鑽 鉗
鉈	铊 𥓿 砣
鉉	铉
鉊	𬬿
鉋	刨 铇
鉌	𰽬
鉍	铋
鉎	𰽫
鉏	𬬺 鋤
鉐	𬬷
鉑	铂
鉒	𰽯
鉔	𫓬
鉕	钷
鉗	鉆 钳
鉘	𰽱
鉙	𰽨
鉚	铆
鉛	鈆 铅
鉜	𰽮
鉝	𫟷
鉞	钺 戉
鉟	𰽧
鉠	𫓭
鉡	𰽰
鉢	缽
鉤	鈎 钩 𰽭
鉥	𬬸
鉦	钲
鉧	𬭁
鉨	鿭
鉬	钼
鉭	钽
鉮	𬬹
鉲	𰽩
鉴	鑒
鉵	𰽶
鉶	铏
鉷	𫟹
鉸	铰
鉹	𰽹
鉺	铒
鉻	铬
鉼	𰽼
鉽	𫟸
鉾	𫓴
鉿	铪
銀	银
銁	𫓲 鈞
銂	𫟻
銃	铳
銅	铜
銈	𫓯
銊	𫓰
銋	𰽻
銍	铚
銏	𫟶
銑	铣
銓	铨
銔	𬭃
銕	鉄 鐵
銖	铢
銗	𬭅
銘	铭
銙	𰽴
銚	铫
銛	铦
銜	㘅 衔
銠	铑
銡	𰽲
銣	铷
銥	铱
銦	铟
銧	𰽵
銨	铵
銩	铥
銪	铕
銫	铯
銬	铐
銮	鑾
銱	铞
銲	𬭍 釬
銳	锐 鋭
銶	𨱇
銷	销
銸	𰽿
銹	锈 鏽
銻	锑
銼	锉 剉
銾	𰾁
鋁	铝
鋂	𰾄
鋃	锒
鋅	锌
鋇	钡
鋉	𨱈
鋊	𰾆
鋋	𮣴
鋌	铤
鋍	𰾀
鋏	铗
鋐	𬭎
鋑	鐫 鑴
鋒	锋
鋗	𫓶
鋘	𬭌
鋙	铻
鋜	𰾃
鋝	锊
鋟	锓
鋠	𫓵
鋡	𰾅
鋣	铘
鋤	鉏 锄
鋥	锃
鋦	锔
鋧	𰽢
鋨	锇
鋩	铓
鋪	舖 铺
鋭	銳
鋮	铖
鋯	锆
鋰	锂
鋱	铽
鋶	锍
鋸	锯
鋹	𬬮
鋼	钢
鋾	𰾏
錀	𬬭
錁	锞
錂	𨱋
錄	录
錆	锖
錇	锫
錈	锩
錋	𬭖
錍	𰾎
錏	铔
錐	锥
錑	𬭜
錒	锕
錔	𰾓
錕	锟
錗	𬭗
錘	鎚 锤
錙	锱
錚	铮
錛	锛
錜	𫓻
錝	𫓽
錞	𬭚
錟	锬
錠	锭
錡	锜
錢	钱
錣	𮣵
錤	𫓹
錥	𫓾
錦	锦
錧	𰾒
錨	锚
錩	锠
錪	𬭓
錫	锡
錭	𬭕
錮	锢
錯	错
錳	锰
錶	表 𰾍
錸	铼
錽	𫓸
錾	鏨
鍀	锝
鍁	锨
鍂	𰾑
鍃	锪
鍄	𨱉
鍆	钔
鍇	锴
鍈	锳
鍉	𫔂 匙
鍊	𫔀
鍋	锅
鍍	镀
鍏	𬬬
鍐	𰾞
鍑	𰾟
鍒	𫔄
鍔	锷
鍖	𰾘
鍘	铡
鍚	钖
鍛	锻 煅
鍜	煆 𰾤
鍝	𰾙
鍟	𰾝
鍠	锽
鍡	𰾚
鍣	𬭡
鍤	锸
鍥	锲
鍦	𰾢
鍧	𰾡
鍨	𰾥
鍩	锘
鍫	鍬
鍬	鍫 锹
鍭	𬭤
鍮	𨱎
鍯	𬭥
鍰	鐶 锾
鍱	𰾕
鍴	𰾜
鍵	键
鍶	锶
鍺	锗
鍼	箴 𰾗 針
鍾	锺 钟
鎂	镁
鎄	锿
鎅	𰾛
鎇	镅
鎈	𫟿
鎉	𰾬
鎊	镑
鎋	𬭪 轄
鎌	𰾮 鐮
鎍	𫔅
鎏	鏐
鎑	𰾩
鎒	𬭦 耨
鎓	𬭩
鎔	镕 熔
鎕	𰾯
鎖	鎻 锁 鏁
鎗	𬬰
鎘	镉
鎙	𫔈 槊
鎚	𬭨 錘
鎛	镈
鎝	𨱏
鎞	𫔇
鎡	镃
鎢	钨
鎣	蓥
鎦	镏
鎧	铠
鎩	铩
鎪	锼
鎬	镐
鎭	鎮
鎮	镇 鎭
鎯	𨱍
鎰	镒
鎲	镋
鎳	镍
鎵	镓
鎶	鿔
鎷	𨰾
鎻	鎖
鎿	镎
鏁	𬭲 鎖
鏂	𰽜
鏃	镞
鏆	𨱌
鏇	镟
鏈	链
鏉	𨱒
鏌	镆
鏍	镙
鏏	𬭬
鏐	鎏 镠
鏑	镝
鏒	𬭝
鏓	𰾱
鏔	𬭰
鏕	𰾲
鏗	铿
鏘	锵
鏙	𰾰
鏚	𬭭
鏜	镗
鏝	镘
鏞	镛
鏟	铲
鏡	镜
鏢	鑣 镖
鏤	镂
鏥	𫔊 銹 鏽
鏦	𫓩
鏨	錾
鏩	𰾌
鏰	镚 斆
鏵	铧
鏷	镤
鏸	𰾶
鏹	镪
鏺	䥽
鏻	𬭸
鏽	锈 銹
鏾	𠜎 𫔌
鐀	𬭢 櫃 匱
鐁	𰾴
鐃	铙
鐄	𨱑
鐇	𫔍
鐈	𫓱
鐉	𰾼
鐊	𬭏
鐋	铴
鐍	𫔎
鐎	𨱓
鐏	𨱔
鐐	镣
鐒	铹
鐓	镦
鐔	镡
鐕	𰾷
鐖	𰽕
鐘	钟
鐙	镫
鐚	𰾪
鐝	镢
鐠	镨
鐤	𰾸
鐥	䦅
鐦	锎
鐧	锏
鐨	镄
鐩	𬭼
鐪	𫓺
鐫	鑴 𰾹 鋑 镌
鐬	𰽷
鐮	镰 鎌
鐯	䦃
鐲	镯
鐳	镭
鐴	𬭽
鐵	鉄 銕 铁
鐶	鍰 镮
鐸	铎
鐹	𰽾
鐺	铛
鐼	𫔁
鐽	𫟼
鐿	镱
鑀	𰾭
鑄	铸
鑇	𬭉
鑈	鿭
鑉	𫠁
鑊	镬
鑋	𰼻
鑌	镔
鑏	𬬾
鑐	𰿂
鑑	鑒 𰾫
鑒	鉴 鑑
鑔	镲
鑕	锧
鑖	𰿃
鑘	𰿄
鑙	𬭿
鑚	鑽
鑛	礦 𰽚
鑞	镴
鑠	铄
鑡	𬭔
鑢	䥨 𮣶
鑣	鏢 镳
鑥	镥
鑨	𰽦
鑪	𬬻
鑭	镧
鑮	𬮁
鑯	𰿈
鑰	钥
鑱	镵
鑲	镶
鑴	鐫 𫔔 鋑
鑷	镊
鑸	𰿉
鑹	镩
鑼	锣
鑽	𰿆 鉆 鑚 钻
鑾	銮
鑿	凿
钀	𰾾
钁	䦆
钃	𰾽
钅	釒
钆	釓
钇	釔
针	針
钉	釘
钊	釗
钋	釙
钌	釕
钍	釷
钎	釺
钏	釧
钐	釤
钑	鈒
钒	釩
钓	釣
钔	鍆
钕	釹
钖	鍚
钗	釵
钘	鈃
钙	鈣
钚	鈈
钛	鈦
钜	鉅
钝	鈍
钞	鈔
钟	鍾 鐘
钠	鈉
钡	鋇
钢	鋼
钣	鈑
钤	鈐
钥	鑰
钦	欽
钧	鈞
钨	鎢
钩	鈎 鉤
钪	鈧
钫	鈁
钬	鈥
钭	鈄
钮	鈕
钯	鈀
钰	鈺
钱	錢
钲	鉦
钳	鉗
钴	鈷
钵	缽
钶	鈳
钷	鉕
钸	鈽
钹	鈸
钺	鉞
钻	鑽
钼	鉬
钽	鉭
钾	鉀
钿	鈿
铀	鈾
铁	鐵
铂	鉑
铃	鈴
铄	鑠
铅	鉛
铆	鉚
铇	鉋
铈	鈰
铉	鉉
铊	鉈
铋	鉍
铌	鈮
铍	鈹
铎	鐸
铏	鉶
铐	銬
铑	銠
铒	鉺
铓	鋩
铔	錏
铕	銪
铖	鋮
铗	鋏
铘	鋣
铙	鐃
铚	銍
铛	鐺
铜	銅
铝	鋁
铞	銱
铟	銦
铠	鎧
铡	鍘
铢	銖
铣	銑
铤	鋌
铥	銩
铦	銛
铧	鏵
铨	銓
铩	鎩
铪	鉿
铫	銚
铬	鉻
铭	銘
铮	錚
铯	銫
铰	鉸
铱	銥
铲	鏟
铳	銃
铴	鐋
铵	銨
银	銀
铷	銣
铸	鑄
铹	鐒
铺	鋪
铻	鋙
铼	錸
铽	鋱
链	鏈
铿	鏗
销	銷
锁	鎖
锂	鋰
锃	鋥
锄	鋤
锅	鍋
锆	鋯
锇	鋨
锈	銹 鏽
锉	銼
锊	鋝
锋	鋒
锌	鋅
锍	鋶
锎	鐦
锏	鐧
锐	銳
锑	銻
锒	鋃
锓	鋟
锔	鋦
锕	錒
锖	錆
锗	鍺
锘	鍩
错	錯
锚	錨
锛	錛
锜	錡
锝	鍀
锞	錁
锟	錕
锠	錩
锡	錫
锢	錮
锣	鑼
锤	錘
锥	錐
锦	錦
锧	鑕
锨	鍁
锩	錈
锪	鍃
锫	錇
锬	錟
锭	錠
键	鍵
锯	鋸
锰	錳
锱	錙
锲	鍥
锳	鍈
锴	鍇
锵	鏘
锶	鍶
锷	鍔
锸	鍤
锹	鍬
锺	鍾
锻	鍛
锼	鎪
锽	鍠
锾	鍰
锿	鎄
镀	鍍
镁	鎂
镂	鏤
镃	鎡
镄	鐨
镅	鎇
镆	鏌
镇	鎮
镈	鎛
镉	鎘
镊	鑷
镋	鎲
镌	鐫
镍	鎳
镎	鎿
镏	鎦
镐	鎬
镑	鎊
镒	鎰
镓	鎵
镔	鑌
镕	鎔
镖	鏢
镗	鏜
镘	鏝
镙	鏍
镚	鏰
镛	鏞
镜	鏡
镝	鏑
镞	鏃
镟	鏇
镠	鏐
镡	鐔
镢	鐝
镣	鐐
镤	鏷
镥	鑥
镦	鐓
镧	鑭
镨	鐠
镩	鑹
镪	鏹
镫	鐙
镬	鑊
镭	鐳
镮	鐶
镯	鐲
镰	鐮
镱	鐿
镲	鑔
镳	鑣
镴	鑞
镵	鑱
镶	鑲
長	长
长	長
門	门
閂	闩
閃	闪
閄	𬮘
閅	𮤫
閆	閻 闫
閈	闬
閉	闭
開	开 𫔭
閌	闶
閍	𨸂
閎	闳
閏	闰
閐	𨸃
閑	闲
閒	闲 間
間	间 閒
閔	闵
閕	𰿩
閗	𫔯
閘	闸
閙	鬧
閛	𰿬
閜	𬮠
閝	𫠂
閞	𫔰
閟	𮤲
閡	阂
関	關 闗 𨶹
閣	阁
閤	𬮤
閥	阀
閦	𬮥
閧	𬮢 鬨
閨	闺
閩	闽
閫	阃
閬	阆
閭	闾
閯	𬮪
閱	阅
閵	𫔴
閶	阊
閷	𰿳
閹	阉 剦
閻	阎 閆
閼	阏
閽	阍
閾	阈
閿	阌
闃	阒
闄	𬮲
闆	板 𬮳
闇	𬮴
闈	闱
闉	𬮱
闊	阔 濶
闋	阕
闌	阑
闍	阇
闐	阗
闑	𫔶
闒	阘
闓	闿
闔	阖
闕	阙
闖	闯
闗	關 関
闚	𬮭
闛	𰿺
關	关 関 闗 寡
闞	阚
闟	𰿻
闠	阓
闡	阐
闢	辟 𰿾
闤	阛
闥	闼
门	門
闩	閂
闪	閃
闫	閆
闬	閈
闭	閉
问	問
闯	闖
闰	閏
闱	闈
闲	閒 閑
闳	閎
间	間
闵	閔
闶	閌
闷	悶
闸	閘
闹	鬧
闺	閨
闻	聞
闼	闥
闽	閩
闾	閭
闿	闓
阀	閥
阁	閣
阂	閡
阃	閫
阄	鬮
阅	閱
阆	閬
阇	闍
阈	閾
阉	閹
阊	閶
阋	鬩
阌	閿
阍	閽
阎	閻
阏	閼
阐	闡
阑	闌
阒	闃
阓	闠
阔	闊
阕	闋
阖	闔
阗	闐
阘	闒
阙	闕
阚	闞
阛	闤
阜	阝
阝	阜
队	隊
阡	仟
阧	陡
阨	呃 阸
阪	坂
阬	坑
阱	汫 穽
阳	陽 氜
阴	陰
阵	陣
阶	階
阸	阨
阿	啊
陀	陁
陁	陀
际	際
陆	陸
陇	隴
陈	陳
陉	陘
降	夅
陕	陝
陗	峭
陘	陉
陜	狹
陝	陕
陡	阧
陣	𨸬 陳 阵
陦	隯
陧	隉
陨	隕
险	險
陰	阴 隂
陳	陈 陣
陶	匋
陸	陆 六
陻	垔 堙
陼	渚
陽	氜 阳
陿	𬯅
隂	陰
隄	堤
隈	渨 偎
隉	陧
隊	队
隍	堭
階	堦 阶
随	隨
隐	隠 隱
隑	𬮿
隕	陨 磒
隖	塢 𬮻
際	际
隝	塢
隠	隐
隣	鄰
隤	墤 𬯎
隧	𡑞
隨	随
隩	𡒃
險	险
隫	𱀡
隮	𬯀 躋
隯	陦
隱	乚 隐
隲	騭 𱀑
隴	陇
隶	隸
隷	隸
隸	隶 隷
隻	只
隼	鶽 鵻
隽	雋
难	難
雁	鴈
集	亼
雇	僱
雋	隽
雍	𪪝 邕
雏	雛
雕	彫 㓮 鵰
雖	虽
雙	双
雛	雏 鶵
雜	杂 襍
雝	簌
雞	鳮 鸡 鷄
雠	讎
離	离
難	难
雨	馭
雱	霶
雲	云
雳	靂
電	电
雾	霧
霁	霽
霜	孀
霡	霢
霢	霡
霣	𫕥
霥	濛
霧	雾
霭	靄
霰	䨘
霶	雱
霸	覇
霼	𪵣
霽	霁
靀	濛
靂	雳
靄	霭
靅	𰷦
靆	叇
靈	灵
靉	叆
靓	靚
静	靜
靚	靓
靜	静
靝	天
面	面 麵
靥	靨
靦	䩄 腼 覥
靧	𫖃 頮
靨	靥
靭	韌
靴	鞾
鞀	鞉 鼗
鞉	鼗 鞀
鞋	鞵 𩋘 𩋧
鞏	巩
鞑	韃
鞒	鞽
鞘	韒
鞙	琄
鞝	绱
鞟	鞹
鞦	鞧
鞧	鞦
鞫	諊
鞯	韉
鞲	韝
鞴	絥
鞵	鞋
鞸	𱁴
鞹	鞟
鞻	𱁺
鞼	𱁹
鞽	橇 鞒
鞾	靴 𫖇
韁	繮 缰
韂	䩞
韃	鞑
韆	𱁶
韇	𱁷
韈	襪 韤
韉	鞯
韊	𱁾
韋	韦
韌	肕 靭 韧
韍	韨
韏	𱂇
韐	𱂆
韒	鞘 𱂉
韓	韩
韔	𮧴
韗	𱂈
韘	𱂊
韙	韪
韚	𫠅
韛	𫖔
韜	韬 弢
韝	𫖕 鞲
韞	韫 縕
韠	𫖒
韡	𮧵
韢	𬰶
韣	𱂋
韤	襪 韈
韦	韋
韧	韌
韨	韍
韩	韓
韪	韙
韫	韞
韬	韜
韭	韮
韮	韭
韵	韻
韻	韵 𱂐
響	响
頁	页
頂	顶 𩠑
頃	顷
頄	𬱓
項	项
順	顺
頇	顸
須	湏 须
頊	顼
頋	顧
頌	颂
頍	𫠆
頎	颀
頏	颃
預	预 豫
頑	顽
頒	颁
頓	顿
頔	𬱖
頕	𬱗
頖	𬱙
頗	颇
領	领
頛	𬱜
頜	颌
頞	𱂨
頟	額 𱂥
頠	𬱟
頡	颉
頢	𬱠
頣	頤
頤	颐 頣
頦	颏
頩	𱂦
頪	𱂧
頫	俯 𫖯
頭	头
頮	颒 靧
頯	𱂬
頰	颊
頲	颋
頴	穎 颕
頵	𫖳
頷	颔
頸	颈
頹	颓
頻	频
頼	賴
顀	𱂭
顁	𬱫
顃	𩖖
顄	𱂰
顅	𫖶
顆	颗
顇	𱂯
顉	𰽳
顊	𬱪
顋	𱂲 腮
題	题
額	额 頟
顎	颚
顏	颜
顐	𬱢
顑	𱂱
顒	颙
顓	颛
顕	顯
顖	囟 𱂶
顗	𫖮
願	𫖸 愿
顙	颡
顛	颠
顜	𱂴
顝	𱂵
類	𩔗 类
顠	𱂺
顢	颟
顣	𫖹
顤	𱂣
顥	皝 颢 皓
顦	憔 𱂻
顧	頋 顾
顩	𱂫
顪	𱂤
顫	颤
顬	颥
顮	𱂸
顯	显 顕
顰	嚬 颦
顱	颅 髗
顳	颞
顴	颧
页	頁
顶	頂
顷	頃
顸	頇
项	項
顺	順
须	鬚 須
顼	頊
顽	頑
顾	顧
顿	頓
颀	頎
颁	頒
颂	頌
颃	頏
预	預
颅	顱
领	領
颇	頗
颈	頸
颉	頡
颊	頰
颋	頲
颌	頜
颍	潁
颎	熲
颏	頦
颐	頤
频	頻
颒	頮
颓	頹
颔	頷
颕	頴
颖	穎
颗	顆
题	題
颙	顒
颚	顎
颛	顓
颜	顏
额	額
颞	顳
颟	顢
颠	顛
颡	顙
颢	顥
颣	纇
颤	顫
颥	顬
颦	顰
颧	顴
風	风
颩	𱃔
颬	𱃕
颭	飐
颮	飇 猋 飑
颯	飒
颰	𩙥
颱	台 𱃗
颲	𱃘
颳	刮
颴	𬱽
颶	飓
颷	𩙪
颸	飔
颹	𬱵
颺	飏
颻	飖
颼	䬒 飕
颽	𬱼
颾	𩙫
颿	𬳳
飀	飗
飁	𱃟
飂	𮨵
飄	飘
飆	飙
飇	𱃠 猋 颮
飈	飚
飉	𬲅
飋	𫗋
飍	𱃝
风	風
飏	颺
飐	颭
飑	颮
飒	颯
飓	颶
飔	颸
飕	颼
飖	颻
飗	飀
飘	飄
飙	飆
飚	飈
飛	飞
飞	飛
食	飠
飠	饣 食
飡	餐 湌
飢	饥 饑
飣	饤
飤	飼 𬲦
飥	饦
飦	饘 𫗞
飨	饗
飩	饨
飪	饪 䏕
飫	饫 饇
飭	饬
飯	饭
飰	𱃴
飲	饮
飴	饴
飵	𫗢
飶	𫗣
飷	𬲭
飼	飤 饲
飽	饱
飾	饰 餙
飿	饳
餀	𮩜
餂	舔 𱃺
餃	饺
餄	饸
餅	饼 餠
餉	饟 饷
養	养
餌	饵
餍	饜
餎	饹
餏	饻
餐	飡
餑	饽
餒	餧 馁
餓	饿
餔	𫗦
餕	馂
餖	饾
餗	𫗧
餘	余 馀
餙	飾
餚	𬳁 肴
餛	馄 餫
餜	䴹 馃
餞	饯
餟	𬳂 醊
餠	餅
餡	馅
餢	𱃾
餣	𬲼
餤	𱃿
餦	𫗠
餧	餒 𫗪 喂
館	馆 舘
餩	𱃽
餪	𫗬
餫	餛 𫗥
餬	𫗫
餭	𫗮
餯	𱄄
餰	𬳆
餱	𫗯 糇
餲	𮩝
餳	饧
餴	𱃼
餵	𫗭 諉 喂
餶	馉
餷	馇
餸	𩠌
餹	𬳍 糖
餺	馎
餻	糕
餼	饩
餽	饋
餾	馏
餿	馊
饀	𬳊
饁	馌
饃	馍
饅	馒
饆	𮩛
饇	飫 𱃲
饈	馐 𦟤
饉	馑
饊	馓 糤
饋	餽 櫃 匱 馈
饌	䉵 馔 籑
饍	膳
饎	𱄆
饐	𮩞
饑	飢
饒	饶
饕	叨
饗	飨
饘	𫗴 飦
饙	𱄀
饛	𱄈
饜	餍
饞	馋 嚵
饟	餉 𫗵
饠	𫗩
饡	𱄊
饢	馕
饣	飠
饤	飣
饥	飢
饦	飥
饧	餳
饨	飩
饩	餼
饪	飪
饫	飫
饬	飭
饭	飯
饮	飲
饯	餞
饰	飾
饱	飽
饲	飼
饳	飿
饴	飴
饵	餌
饶	饒
饷	餉
饸	餄
饹	餎
饺	餃
饻	餏
饼	餅
饽	餑
饾	餖
饿	餓
馀	餘
馁	餒
馂	餕
馃	餜
馄	餛
馅	餡
馆	館
馇	餷
馈	饋
馉	餶
馊	餿
馋	饞
馌	饁
馍	饃
馎	餺
馏	餾
馐	饈
馑	饉
馒	饅
馓	饊
馔	饌
馕	饢
馘	聝
馚	馩
馩	𬳟 馚
馬	马
馭	驭 御
馮	冯 溤
馯	𫘛
馱	䭾 驮
馲	𱄽
馳	驰
馴	驯
馵	𱄼
馹	驲
馺	𱅂
馼	𫘜
馽	𱅁
馿	驢
駁	駮 驳
駂	𱅀
駃	𫘝
駉	𬳶
駊	𫘟
駍	𬳴
駎	𩧨
駏	𱅃
駐	驻
駑	驽
駒	驹
駓	𬳵
駔	驵
駕	驾
駗	𱅇
駘	骀
駙	驸
駚	𩧫
駛	𩢲 驶
駜	𱅈
駝	驼
駞	𫘞
駟	驷
駢	骈 騈
駣	𱅏
駤	𫘠
駥	𱅉
駦	騰
駧	𩧲
駩	𩧴
駪	𬳽 侁 詵
駫	𫘡
駬	𱅋
駭	骇
駮	駁 𱅐
駰	骃
駱	骆
駴	𮪢
駶	𩧺
駷	𱅔
駸	骎
駹	𮪡
駺	𬴀
駻	𫘣
駼	𬳿
駽	𱅖
駾	𱅙
駿	骏
騀	𱅗
騁	骋
騂	骍
騃	𫘤
騄	𫘧
騅	骓
騇	𱅚
騈	駢
騉	𫘥
騊	𫘦
騋	𱅕
騌	騣 骔
騍	骒
騎	骑
騏	骐
騐	驗
騑	𬴂
騔	𩨀
騕	𱅜
騖	骛
騗	𱅝 騙
騘	驄
騙	骗 騗
騚	𩨊
騜	𫘩
騝	𩨃
騞	𬴃
騟	𩨈
騠	𫘨
騢	𱅞
騣	𮪣 騌
騤	骙
騥	𱅟
騧	䯄
騩	𱅡
騪	𩨄
騫	骞
騬	𱅢
騭	骘 隲
騮	骝
騯	𬴅
騰	腾 駦
騱	𫘬
騲	𮪤
騳	𱄿
騴	𫘫
騵	𫘪
騶	驺
騷	骚
騸	骟
騹	𬴆
騺	𱅊
騻	𫘭
騼	𫠋
騽	𱅩
騾	驘 骡
驀	蓦
驁	骜
驂	骖
驃	骠
驄	騘 骢
驅	驱 敺
驈	𱅫
驉	𱅧
驊	骅 𦽊
驋	𩧯
驌	骕
驍	骁
驎	𬴊
驏	骣
驐	𮪥
驒	𱅛
驓	𫘯
驔	𱅪
驕	骄
驖	𬴋
驗	验 騐
驘	騾
驙	𫘰
驚	惊
驛	驿
驞	𱅤
驟	骤
驠	𱅬
驡	𱅅
驢	驴 馿
驤	骧
驥	骥
驦	骦
驨	𫘱
驩	𬴐
驪	骊
驫	骉
马	馬
驭	馭
驮	馱
驯	馴
驰	馳
驱	驅
驲	馹
驳	駁
驴	驢
驵	駔
驶	駛
驷	駟
驸	駙
驹	駒
驺	騶
驻	駐
驼	駝
驽	駑
驾	駕
驿	驛
骀	駘
骁	驍
骂	罵
骃	駰
骄	驕
骅	驊
骆	駱
骇	駭
骈	駢
骉	驫
骊	驪
骋	騁
验	驗
骍	騂
骎	駸
骏	駿
骐	騏
骑	騎
骒	騍
骓	騅
骔	騌
骕	驌
骖	驂
骗	騙
骘	騭
骙	騤
骚	騷
骛	騖
骜	驁
骝	騮
骞	騫
骟	騸
骠	驃
骡	騾
骢	驄
骣	驏
骤	驟
骥	驥
骦	驦
骧	驤
骯	肮 腌
骴	𦙼 胔
骻	胯
骽	腿
骾	挭 鯁
髃	腢
髅	髏
髋	髖
髌	髕
髏	髅
髐	𱅮
髒	脏
體	体
髕	臏 髌
髖	髋
髗	顱
高	髙
髙	高
髣	彷
髮	发
髻	䯻
髼	鬅
鬀	剃
鬂	鬢
鬅	髼
鬆	松
鬍	胡
鬒	㐱
鬓	鬢 𩯭
鬖	𩭹
鬗	𱆆
鬚	须
鬜	𱆁
鬝	𱆀
鬞	𬴩
鬠	𫘽
鬡	𮫂
鬢	鬓 鬂
鬣	巤
鬥	斗 鬭 鬦 鬬 鬪
鬦	鬥
鬧	閙 闹
鬨	閧
鬩	阋
鬪	鬬 鬥
鬬	鬪 鬥
鬭	鬥
鬮	阄 䰗
鬱	欝 郁
鬶	鬹
鬹	鬶
鬺	𱆌
魇	魘
魉	魎
魎	魉
魏	巍
魗	𱆛
魘	魇
魙	聻
魚	鱼
魛	鱽
魜	𬶁
魝	𬶀
魟	𫚉 鰩
魠	𱇏
魡	𬶄
魢	鱾
魣	𮬛
魥	𩽹
魦	鯊 𫚌
魧	𱇘
魨	鲀
魪	𬶇
魫	𱇙
魬	𱇖
魭	𱇐
魮	𱇒
魯	鲁
魱	𱇓
魴	鲂
魵	𫚍
魶	𱇔
魷	鰌 鱿
魺	鲄
魻	𱇟
魼	𱇜
魽	𫠐
魾	𱇝
鮀	𬶍
鮁	鲅
鮂	𱇠
鮃	鲆
鮄	𫚒
鮅	𫚑
鮆	𫚖
鮇	𱇛 䱅
鮈	𬶋
鮊	鲌
鮋	鲉
鮌	𱇢
鮍	鲏
鮎	鲇
鮏	𱇡
鮐	鲐
鮑	鲍
鮒	鲋
鮓	鲊
鮘	𬶌
鮚	鲒
鮛	𱇨
鮜	鲘
鮝	鯗
鮞	鲕
鮟	𩽾
鮠	𬶏
鮡	𬶐
鮣	䲟
鮤	𫚓
鮥	𱇪
鮦	鲖
鮧	𱇧 鯷
鮨	𮬜
鮪	鲔
鮫	鲛
鮬	𱇦
鮭	鲑
鮮	鲜 鱻
鮯	𫚗
鮰	𫚔
鮳	鲓
鮵	𫚛
鮶	鲪
鮷	𬶕
鮸	𩾃
鮹	𱇯
鮺	鲝
鮻	𱇳
鮿	𫚚
鯀	鲧
鯁	挭 鲠 骾
鯄	𩾁
鯅	𱈁
鯆	𫚙
鯇	鲩
鯈	𱇱
鯉	鲤
鯊	鲨 魦
鯌	𬶔
鯒	鲬
鯔	鲻
鯕	鲯
鯖	鲭
鯗	鮝 鲞
鯚	𱇺
鯛	鲷
鯝	鲴
鯞	𫚡
鯠	𱇭
鯡	鲱
鯢	鲵
鯤	鲲
鯥	𱇶
鯦	𱇼
鯧	鲳 䱽
鯨	鲸
鯩	𱇗
鯪	鲮
鯫	鲰
鯬	𫚞
鯮	𱇾
鯰	鲶
鯱	𩾇
鯴	鲺
鯶	𩽼
鯷	鮧 鳀
鯸	𱈄
鯹	𬶢
鯻	𬶟
鯼	𱈅
鯽	鲫
鯾	𫚣
鯿	鳊
鰁	鳈
鰂	鲗
鰃	鳂
鰅	𱈂
鰆	䲠
鰇	𬶧
鰈	鲽
鰉	鳇 鱑
鰊	𬶠
鰋	𫚢
鰌	䲡 鰍 魷
鰍	鰌 鳅
鰏	鲾
鰐	鱷 鳄
鰑	𫚊
鰒	鳆
鰓	鳃
鰕	𫚥 蝦
鰗	𬶞
鰜	鳒
鰝	𱈋
鰟	鳑
鰠	鳋
鰡	𱈊
鰣	鲥
鰤	𫚕
鰥	鳏
鰦	𫚤
鰧	䲢
鰨	鳎
鰩	鳐 魟
鰫	𫚦
鰬	𱈉
鰭	鳍
鰮	鳁
鰯	𱈍
鰱	鲢
鰲	鼇 鳌
鰳	鳓
鰴	𱈑
鰵	鳘
鰶	𬶭
鰷	鲦
鰹	鲣
鰺	鲹
鰻	鳗
鰼	鳛
鰽	𫚧
鰾	鳔
鰿	𱇵
鱀	𬶨
鱁	𱈏
鱂	鳉
鱃	𱈌
鱄	𱈐 𫚋
鱅	鳙
鱆	𫠒
鱇	𩾌
鱈	鳕
鱉	鼈 鳖
鱊	𫚪
鱋	𬶬
鱌	𬶲
鱍	𱇣
鱎	𱇩
鱏	𱈓
鱐	𱇿
鱑	鰉 𬶫
鱒	鳟
鱓	䱇 鱔 𬶛
鱔	鱓 鳝
鱕	𱈕
鱖	鳜
鱗	鳞
鱘	鲟
鱚	𬶮
鱝	鲼
鱞	𬶵
鱟	鲎
鱠	鲙 膾
鱢	𫚫
鱣	鳣
鱤	鳡
鱥	𮬝
鱦	𱇸
鱧	鳢
鱨	鲿 𱈘
鱬	𱈗
鱭	鲚
鱮	𫚈
鱯	鳠
鱲	𫚭
鱴	𱈙
鱵	𮬤
鱷	𱈚 鰐 鳄
鱸	鲈
鱹	𬶺
鱺	鲡
鱻	鮮 𱈜
鱼	魚
鱽	魛
鱾	魢
鱿	魷
鲀	魨
鲁	魯
鲂	魴
鲃	䰾
鲄	魺
鲅	鮁
鲆	鮃
鲇	鮎
鲈	鱸
鲉	鮋
鲊	鮓
鲋	鮒
鲌	鮊
鲍	鮑
鲎	鱟
鲏	鮍
鲐	鮐
鲑	鮭
鲒	鮚
鲓	鮳
鲔	鮪
鲕	鮞
鲖	鮦
鲗	鰂
鲘	鮜
鲙	鱠
鲚	鱭
鲛	鮫
鲜	鮮
鲝	鮺
鲞	鯗
鲟	鱘
鲠	鯁
鲡	鱺
鲢	鰱
鲣	鰹
鲤	鯉
鲥	鰣
鲦	鰷
鲧	鯀
鲨	鯊
鲩	鯇
鲪	鮶
鲫	鯽
鲬	鯒
鲭	鯖
鲮	鯪
鲯	鯕
鲰	鯫
鲱	鯡
鲲	鯤
鲳	鯧
鲴	鯝
鲵	鯢
鲶	鯰
鲷	鯛
鲸	鯨
鲹	鰺
鲺	鯴
鲻	鯔
鲼	鱝
鲽	鰈
鲾	鰏
鲿	鱨
鳀	鯷
鳁	鰮
鳂	鰃
鳃	鰓
鳄	鰐 鱷
鳅	鰍
鳆	鰒
鳇	鰉
鳈	鰁
鳉	鱂
鳊	鯿
鳋	鰠
鳌	鰲
鳍	鰭
鳎	鰨
鳏	鰥
鳐	鰩
鳑	鰟
鳒	鰜
鳓	鰳
鳔	鰾
鳕	鱈
鳖	鱉
鳗	鰻
鳘	鰵
鳙	鱅
鳚	䲁
鳛	鰼
鳜	鱖
鳝	鱔
鳞	鱗
鳟	鱒
鳠	鱯
鳡	鱤
鳢	鱧
鳣	鱣
鳤	䲘
鳥	鸟
鳦	𱉇
鳧	凫
鳩	鸠
鳭	𱉈
鳮	雞 鷄
鳱	𱉊
鳲	鸤
鳳	凤
鳴	鸣
鳶	鸢
鳷	𫛛
鳸	𱉓
鳺	𱉎
鳻	𱉑
鳼	𪉃
鳽	𫛚
鳾	䴓
鳿	𱉍
鴀	𫛜
鴁	𮭢
鴂	𱉔
鴃	𫛞 鵙
鴄	裒
鴅	𫛝
鴆	鸩 酖
鴇	鸨
鴈	雁
鴉	鸦
鴍	𬸀
鴐	𫛤
鴒	鸰
鴓	𮭤
鴔	𫛡
鴕	鸵
鴗	𫁡
鴘	𱉡
鴙	𱉛
鴚	𱉕
鴛	鸳
鴜	𪉈
鴝	鸜 朐 鸲
鴞	鸮 梟
鴟	鸱
鴠	𱉗
鴡	𱉘
鴢	𱉢
鴣	鸪
鴥	𫛣
鴦	鸯
鴨	鸭
鴩	𱉚
鴮	𫛦
鴯	鸸
鴰	鸹
鴱	𱉪
鴲	𪉆
鴳	𫛩 鷃
鴴	鸻
鴶	𱉥
鴷	䴕
鴸	𱉫
鴹	𱉯
鴺	𱉩 鵜
鴻	鸿
鴽	𫛪
鴾	𱉲
鴿	鸽
鵀	𬸊
鵁	䴔
鵂	鸺
鵃	鸼
鵄	𬸈
鵅	𱉮
鵊	𫛥
鵋	𱉽
鵌	𱉸
鵎	𱉻
鵏	𬷕
鵐	鹀
鵑	鹃
鵒	鹆
鵓	鹁
鵔	𱉿
鵕	𱉾
鵖	𱉝
鵗	𱉹
鵙	鴃 𱉐
鵚	𪉍
鵛	𱉠
鵜	鴺 鹈
鵝	鵞 鹅
鵞	鵝
鵟	𫛭
鵠	鹄
鵡	鹉
鵧	𫛨
鵩	𫛳
鵪	鹌
鵫	𫛱
鵬	鹏
鵮	鹐
鵯	鹎
鵰	雕 彫 𫛲
鵱	𱊀
鵲	鹊
鵳	𱊋
鵴	𱊇
鵵	𱊆
鵶	𱉨
鵷	鹓
鵸	𱊁
鵹	𱊃
鵻	𱊅 隼
鵼	𱊊
鵽	𱊍
鵾	鹍
鶀	𬸒
鶂	𬷼 𱊈 鶃
鶃	鶂 𱊄
鶄	䴖
鶅	𱊎
鶆	𱉵
鶇	鸫
鶉	鹑
鶊	鹒
鶋	𱊌
鶌	𫛵
鶒	𫛶
鶓	鹋
鶔	𱊗
鶕	𬸝
鶖	鹙
鶗	𫛸
鶘	鹕
鶙	𱊕
鶚	鹗
鶛	𱊐
鶝	𱊏
鶞	𱊑
鶟	𱊖
鶠	𬸘
鶡	鹖
鶢	𱊒
鶣	𬸜
鶤	𱉱
鶥	鹛
鶦	𫛷
鶨	𱊘
鶩	鹜
鶪	䴗
鶬	鸧
鶭	𫛯
鶯	莺 鸎
鶰	𫛫
鶱	𬸣
鶲	鹟
鶴	鹤
鶵	雛 𬸅
鶶	𱊝
鶷	𱊟
鶹	鹠
鶺	鹡
鶻	鹘
鶼	鹣
鶽	𱊛 隼
鷀	鹚
鷁	鹢
鷂	鹞
鷃	鴳 𮭨
鷄	鳮 雞
鷅	𫛽
鷇	𬆮
鷈	䴘
鷉	䴘
鷊	鹝
鷋	𱊠
鷎	𬸢
鷏	𱊚
鷐	𫜀
鷑	𱊢
鷒	𱉏
鷓	鹧
鷔	𪉑
鷕	𱊡
鷖	鹥
鷗	鸥
鷙	鸷
鷚	鹨
鷛	𱊤
鷜	𬸞
鷞	𮭪
鷟	𬸦
鷢	𱊧
鷣	𫜃
鷤	𫛴
鷥	鸶
鷦	鹪
鷧	𱊦
鷨	𪉊
鷩	𫜁 氅
鷫	鹔
鷭	𬸪
鷮	𱉬
鷯	鹩
鷰	𬸧
鷲	鹫
鷳	鹇
鷵	𱊩
鷶	𱉳
鷷	𫜄
鷸	鹬
鷹	鹰
鷺	鹭
鷽	鸴
鷾	𱊰
鷿	䴙 𬸯
鸀	𱊬
鸁	𱊮
鸂	㶉
鸃	𱉌
鸄	𱊯
鸅	𱉟
鸆	𱊫
鸇	鹯
鸉	𱉴
鸊	䴙
鸋	𫛢
鸌	鹱
鸎	𬸕 鶯
鸏	鹲
鸐	𱊱
鸑	𬸚
鸒	𱊭 𱉰
鸓	𱊳
鸕	鸬
鸖	𬸰
鸗	𫛟
鸘	鹴
鸙	𱊵
鸚	鹦
鸛	鹳
鸜	鴝 朐 𬸱
鸝	鹂
鸞	鸾
鸟	鳥
鸠	鳩
鸡	雞
鸢	鳶
鸣	鳴
鸤	鳲
鸥	鷗
鸦	鴉
鸧	鶬
鸨	鴇
鸩	鴆
鸪	鴣
鸫	鶇
鸬	鸕
鸭	鴨
鸮	鴞
鸯	鴦
鸰	鴒
鸱	鴟
鸲	鴝
鸳	鴛
鸴	鷽
鸵	鴕
鸶	鷥
鸷	鷙
鸸	鴯
鸹	鴰
鸺	鵂
鸻	鴴
鸼	鵃
鸽	鴿
鸾	鸞
鸿	鴻
鹀	鵐
鹁	鵓
鹂	鹃 鸝
鹃	鹂 鵑
鹄	鵠
鹅	鵝
鹆	鵒
鹇	鷳
鹈	鵜
鹉	鵡
鹊	鵲
鹋	鶓
鹌	鵪
鹍	鵾
鹎	鵯
鹏	鵬
鹐	鵮
鹑	鶉
鹒	鶊
鹓	鵷
鹔	鷫
鹕	鶘
鹖	鶡
鹗	鶚
鹘	鶻
鹙	鶖
鹚	鷀
鹛	鶥
鹜	鶩
鹝	鷊
鹞	鷂
鹟	鶲
鹠	鶹
鹡	鶺
鹢	鷁
鹣	鶼
鹤	鶴
鹥	鷖
鹦	鸚
鹧	鷓
鹨	鷚
鹩	鷯
鹪	鷦
鹫	鷲
鹬	鷸
鹭	鷺
鹮	䴉
鹯	鸇
鹰	鷹
鹱	鸌
鹲	鸏
鹳	鸛
鹴	鸘
鹵	卤
鹹	咸
鹺	鹾
鹻	碱 堿 鹼
鹼	鹻 硷 碱 堿
鹽	盐 䀋 塩 𥂁
鹾	鹺
麄	觕 麤 粗
麇	麕
麐	麟
麕	麇
麗	丽
麞	獐
麟	麐
麡	𬸾
麤	麄 觕 粗
麥	麦
麦	麥
麧	𱋇
麨	𪎊
麩	麸
麪	麵
麫	麵
麬	𤿲
麮	𱋋
麯	𱋐 麴 曲
麰	牟 𮮇
麱	𱋖
麲	𪎉
麳	𪎌
麴	麹 麯
麵	麫 面 麪
麷	𫜑
麸	麩
麹	麴
麻	蔴
麼	庅 麽 么
麽	庅 么 麼
黂	𱋱
黃	黄
黄	黃
黉	黌
黌	黉
黏	粘
黑	黒
黒	黑
默	嘿 黙
黙	默
點	点
黡	黶
黨	党
黩	黷
黪	黲
黲	黪
黶	黡
黷	黩
黸	𱋶
黽	黾
黾	黽
黿	鼋
鼀	𱋾
鼁	𱋿
鼃	蛙
鼄	蛛 𬹣
鼅	𱌄
鼆	𱌆
鼇	鰲
鼈	𱌇 鱉
鼉	鼍
鼊	𱌉
鼋	黿
鼍	鼉
鼎	𪔂
鼏	幂 冪
鼓	皷 鼔
鼔	皷 鼓
鼗	鞉 鞀
鼚	𱌊
鼲	𱌏
鼴	鼹
鼹	鼴
齁	𪖙
齅	嗅
齈	𱌖
齊	齐 齋 斉 亝 斋
齋	斋 齊
齌	𱌗
齍	𱌘
齎	赍 賫
齏	齑
齐	齊
齑	齏
齒	齿
齔	龀
齕	龁
齖	𬹺
齗	龂
齘	𬹼
齙	龅
齚	𱌬
齜	龇
齝	𱌯
齞	𱌫
齟	龃
齠	龆
齡	龄
齣	𱌮 出
齤	𱌲
齥	𱌱
齦	龈 啃
齧	囓 𫜩
齩	𫜪 咬
齪	龊
齬	龉
齭	𫜭
齮	𬺈
齯	𫠜
齰	𫜬
齱	𱌶
齲	龋
齳	𱌳
齴	𫜮
齵	𱌹
齶	腭
齷	龌
齸	𱌽
齹	𬺎
齺	𱌭
齻	𱌺
齼	𬺓
齽	𬺔
齾	𫜰
齿	齒
龀	齔
龁	齕
龂	齗
龃	齟
龄	齡
龅	齙
龆	齠
龇	齜
龈	齦
龉	齬
龊	齪
龋	齲
龌	齷
龍	竜 龙 龒
龎	厐 龐
龏	𱍁
龐	庞 龎
龑	䶮
龒	龍
龓	𫜲 䪊
龔	龚
龕	龛
龖	𱍂
龙	龍
龚	龔
龛	龕
龜	龟
龝	𬓫 秋
龞	𱍈
龟	龜
龠	籥
龡	吹
龢	和 咊
龤	諧
龥	籲 𬱳
龭	𩨎
龯	𨱆
龲	𰾋
龽	𰞳
鿁	䜤
鿃	䀹
鿌	涼
鿎	䃮
鿏	䥑
鿐	䲤
鿒	鿓
鿓	鿒
鿔	鎶
鿕	𱆥
鿭	鉨 鑈
益	益
礼	礼 禮
𠀾	𠁞
𠁔	𫷘
𠁞	𠀾
𠂝	眾 衆
𠂤	堆 𣳨
𠂲	𬓡
𠃓	昜
𠆌	庸
𠆲	儣
𠆿	𠌥
𠇐	㒜
𠇱	佅
𠇹	俓
𠉂	㒓
𠉗	𠏢
𠊧	併
𠌥	𠆿
𠎅	𰂃
𠎒	𫢨
𠏢	𠉗
𠏮	𫢘
𠐇	𭫝
𠐊	𫝋
𠐍	𫣫
𠐮	𬾣
𠐽	𫢔
𠑇	𰂻
𠑙	𫢹
𠑲	𫣛
𠔃	兮
𠕄	凹
𠖥	寵
𠖫	𫤽
𠗥	湆
𠗦	憑
𠗧	測
𠗨	渫
𠗯	湶
𠗳	溓
𠗵	滂
𠗶	溏
𠗽	漻
𠗾	漺
𠗿	滲 𰄁
𠘂	漱
𠘆	潹
𠘈	潺
𠘉	澋
𠘊	濃
𠘋	濎
𠘎	澮
𠘐	澶
𠘙	濼
𠘝	瀨
𠘟	瀝
𠘠	瀤
𠘣	灂
𠘥	𫥍
𠚳	𠠎
𠚹	芟
𠛅	剾
𠛆	𠞆
𠛾	𪟖
𠜎	鏾
𠜲	𫥼
𠜼	掐
𠝿	𫦁
𠞆	𠛆
𠞭	𫦉
𠞰	剿
𠟪	𫥺
𠠎	𠚳
𠠏	𫥵
𠠝	𫥳
𠠫	𰄭
𠡠	勑
𠦌	卌 𠦜
𠦜	卌 𠦌
𠩘	𫨆
𠩬	𰆙
𠬙	𪠡
𠬤	睪
𠭴	㑁
𠮷	吉
𠯗	咂
𠯟	哯
𠯠	噅
𠰌	味
𠰷	嚧
𠱓	𠼮
𠱘	𠸺
𠱞	𫝜
𠲥	𡅏
𠲿	欶
𠳞	𠶸
𠴢	𡄔
𠵔	𭇴
𠵘	𫩖
𠵸	𡄣
𠵹	𫩚
𠵾	㗲
𠶸	𠳞
𠶹	𰇡
𠷌	𰇘
𠷏	𫡬
𠸺	𠱘
𠹛	𫩯
𠺖	𭈈
𠺮	𫪅
𠼗	𫪚
𠼤	𫪄
𠼮	𠱓 𫩳
𠽈	𭈟
𠽸	𬱞
𠾖	器
𠾬	𫪽
𠿕	𪜎
𠿘	𭉨
𠿿	𭇀
𡀠	𭈜
𡀿	𫫵
𡁚	𭇙
𡁯	𭇡
𡂒	𫪪
𡂡	𪢒
𡂿	𫪘
𡃄	𪡺
𡃈	𰈮
𡃤	𪢐
𡄔	𠴢
𡄖	𭈉
𡄣	𠵸
𡄤	𭈮
𡄩	𭝫
𡅈	嚹
𡅏	𠲥
𡅘	𭊸
𡅥	𫬟
𡅧	𭉼
𡈙	囮
𡈛	㘤
𡈼	壬
𡉟	壯
𡊑	壐
𡋀	𡓾
𡋗	𡑭
𡋤	壗
𡍫	𫭮
𡏆	𡒶
𡑍	𫭼
𡑎	𫭯
𡑞	隧
𡑭	𡋗
𡑯	𰉱
𡒃	隩
𡒄	壈
𡒶	𡏆
𡓁	𪤄
𡓗	𫝡
𡓦	𰊅
𡓾	𡋀
𡗆	𰋖
𡚁	弊
𡜱	嫉
𡝠	㜷
𡞋	㜗
𡞱	㜢
𡞵	㛟
𡞾	嫩 嫰
𡟫	𫝪
𡠚	𰋾
𡠟	孎
𡠹	㛿
𡡇	𡣨
𡢃	㛠
𡢘	𰌉
𡢿	𭑸
𡣨	𡡇
𡤠	𫰣
𡤡	𭑹
𡤫	𫱿
𡥧	孻
𡨴	寧
𡭜	𡮉
𡭬	𡮣
𡮉	𡭜
𡮣	𡭬
𡮤	𫴼
𡱆	屬 属
𡲕	屜
𡳃	𡳳
𡳒	𦘧
𡳳	𡳃
𡵝	嵸
𡶴	嵼
𡷨	𫵸
𡸃	𡽗
𡸗	𪨩
𡹬	𪨹
𡺃	嶈
𡺠	𰎝
𡺨	𫵶
𡻕	岁 歲 亗
𡻘	𭗡
𡼱	𰎢
𡼾	𰎛
𡽗	𡸃
𡽳	𫶊
𡽵	𫵹
𡾆	𰎷
𡾱	㟜
𡿖	𪩛
𢀖	巠
𢂑	拭
𢄓	𰏓
𢄼	𫷈
𢅏	簾 㡘
𢅖	簾
𢅡	𫷌
𢅣	𭘚
𢆞	䄯
𢉿	𰏲
𢊃	𰏽
𢊍	㕑 厨
𢋈	㢝
𢍰	𪪴
𢍺	弋
𢐗	𰐚
𢐧	檠
𢓅	𢕩
𢕐	訇 渹
𢕩	𢓅
𢖕	𪢈
𢖽	志
𢗓	㦛
𢗿	怽
𢘙	𢤱
𢘝	𢣚
𢘞	𢣭
𢙐	憹
𢙑	𢠼
𢙒	憢
𢙓	懀
𢙢	恐
𢙱	㑝
𢛔	𫹼
𢛯	㦎
𢜫	惺
𢜭	𪫸
𢟼	懜
𢠰	𰑅
𢠳	憋
𢠵	惝
𢠼	𢙑
𢢀	𫺒
𢣏	㦈
𢣐	𪬚
𢣚	𢘝
𢣭	𢘞
𢤌	𫻇
𢤜	𫺫
𢤧	𰒖
𢤩	𪫡
𢤱	𢘙
𢤿	𪬯
𢥠	𫹷 悚
𢧐	戰
𢪓	擧
𢪗	𢷏
𢫊	𢷮
𢫘	攎
𢫞	𢶫
𢫬	摋
𢫮	𢬎
𢬍	擫
𢬎	𢫮
𢬦	𢹿
𢭆	抽
𢭏	擣
𢯦	𫼲
𢯩	𫼤
𢯱	搜
𢯷	𪭝
𢰾	摠 總
𢱡	𫼶
𢲐	𰓝
𢲩	𫼾
𢲫	𫼗
𢲷	搜
𢲸	𫼵
𢲾	𫼫
𢳂	𫼣
𢳆	摮
𢳚	𫽐
𢳜	漇
𢴦	𫽙
𢴩	𫽳
𢵣	𭡵
𢶑	𢸣 𫽲
𢶒	𪭯
𢶣	㩹
𢶫	𢫞
𢷃	𫽔
𢷏	𢪗
𢷞	𭢕
𢷮	𢫊
𢸁	挙
𢸔	𭢋
𢸙	𭡜
𢸣	𢶑
𢸳	𫾃
𢸴	𫾁
𢸸	𰓕
𢹏	𰔶
𢹥	𰓗
𢹼	𰓟
𢹿	𢬦
𢺎	𭢝
𢺳	𪮳
𢽾	斅
𢿓	𫿂
𢿡	𰕐
𣀘	𫾳
𣀷	𫾲
𣀻	𫿗
𣁚	𣁟
𣁟	𣁚
𣃁	斸
𣄈	㫎
𣄸	𬀥
𣆐	曥
𣇀	晡
𣈣	𣋋
𣈶	暅
𣉞	暠
𣉼	𣋞
𣊯	𭥓
𣋋	𣈣
𣋞	𣉼
𣌂	𬁑
𣍐	𫧃
𣍨	𦢈
𣍯	腪
𣍰	脥
𣍷	脼
𣎄	𦞌
𣎑	臗
𣎜	𰮭
𣎟	𦠅
𣏢	槫
𣐕	桱
𣐤	欍
𣑝	檲
𣑶	𣠲
𣒌	楇
𣒗	㮝
𣓌	槹
𣓿	橯
𣔼	竿
𣔿	𰗘
𣕲	㮓
𣗊	樠
𣗋	欓
𣘐	㯤
𣘓	𣞻
𣘴	檭
𣘷	𣝕
𣘾	𬛕
𣙎	㭣
𣙥	㯼
𣙿	𬃮
𣚙	𬃦
𣚚	欘
𣛣	𬂻
𣝕	𣘷
𣞁	㮠
𣞎	𣠩
𣞐	𰗚
𣞻	𣘓
𣠕	𬄞
𣠩	𣞎
𣠲	𣑶
𣡌	𬄬
𣡶	𬃳
𣤋	𰙕
𣤿	𬶷
𣦵	歹
𣦶	歹
𣨼	殢
𣩕	𬆙
𣫒	𫶲
𣭤	𣯴
𣯣	𣯩
𣯩	𣯣
𣯴	𣭤
𣯶	毶
𣰛	𰚱
𣰨	𬇄
𣱝	氭
𣲗	湋
𣳆	㵗
𣳨	𠂤
𣴇	𰝜
𣶩	澅
𣶫	𣿉
𣶯	𰛉
𣸣	濆
𣺼	灙
𣺽	𤁣
𣻏	𬇼
𣻑	𭰒
𣼊	𭰗
𣼩	𰛺
𣽏	𪶮
𣽷	瀃
𣾍	㶌
𣾷	㳢
𣿉	𣶫
𤀪	𬈱
𤁣	𣺽
𤁪	𬈾
𤄙	𰝞
𤄷	𪶒
𤅙	𬇬
𤅩	𭰥
𤅷	𰛻
𤆍	赤
𤆡	熓
𤆢	㷍
𤇃	爄
𤇄	熌
𤇭	爖
𤇻	𭶙
𤈶	熉
𤈷	㷿
𤊀	𤒎
𤋏	熡
𤍖	𬊗
𤍜	𰞷
𤍠	熱
𤎤	𬝃
𤎱	臇 纂 㷪
𤎺	𤓎
𤎻	𤑳
𤏐	𭴳
𤑕	熏
𤑳	𤎻
𤑹	𪹀
𤒎	𤊀
𤒦	𬋃
𤒻	𪹹
𤓌	𪹠
𤓎	𤎺
𤓓	𬊜
𤕪	爿
𤕭	將 将
𤕯	漿
𤘀	𪺣
𤙯	𤛮
𤛮	𤙯
𤛱	𫞢
𤜆	𪺪
𤜵	𤡲
𤝢	𤢟
𤞃	獩
𤞤	玁
𤟤	𰡋
𤠋	㺏
𤠔	𰡐
𤠮	𪺸
𤡲	𤜵
𤢕	斁
𤢟	𤝢
𤢪	獵
𤣎	𰡢
𤣤	𬌴
𤥭	𰡰
𤦀	瓕
𤧚	璁
𤩂	𫞧
𤩽	瓛
𤪺	㻘
𤫩	㻏
𤬅	𪼴
𤮦	𬎬
𤮨	礱
𤲓	𭻔
𤲢	𭻍
𤳄	𤳸
𤳷	𪽝
𤳸	𤳄
𤶊	癐
𤶧	𤸫
𤷃	𪽭
𤷽	㾡
𤸫	𤶧
𤹺	𤻜
𤺉	𰣦
𤺔	𪽴
𤻊	㿗
𤻜	𤹺
𤻝	𰣩
𤻲	𬏤
𤼈	𰣫
𤽜	皌
𤽯	㿧
𤾀	皟
𤾉	𰤓
𤿲	麬
𥀬	𪠏
𥀲	𰤫
𥁕	昷
𥁢	䀉
𥂁	鹽
𥂫	𰤽
𥂸	𬐠
𥅘	𥌃
𥅴	䀹
𥅾	䚎
𥆧	瞤
𥇔	𬑇
𥇢	䁪
𥈟	瞍
𥉸	𰥣
𥋝	𰥭
𥋟	䂀
𥌃	𥅘
𥌚	𬑙
𥎝	䂎
𥏝	𪿊
𥐘	石
𥐞	硭
𥐟	礒
𥐯	𥖅
𥐰	𥕥
𥐻	碙
𥑘	砞
𥓿	鉈 砣
𥔀	訇 渹
𥔂	𮀲
𥕤	礚
𥕥	𥐰
𥖅	𥐯
𥖏	𮀪
𥖩	𬒊
𥖲	𪿞
𥗇	𪿵
𥗴	𬒓
𥗹	𰧈
𥗺	𬒇
𥗽	𬒗
𥘃	𮀡
𥘯	祙
𥜌	澳 襖
𥜐	𫀓
𥜰	𫀌
𥝢	利
𥞊	秣
𥞦	𥞵
𥞵	𥞦
𥟂	䅘
𥢊	𬓱
𥢢	䅪
𥢶	𫞷
𥢷	𫀮
𥥅	竉
𥧂	𥨐
𥨐	𥧂
𥩺	𥪂
𥪂	𥩺
𥫱	囤
𥬀	䉙
𥬈	篵
𥬞	籋
𥬠	篘
𥭉	𥵊
𥮋	𥸠
𥮜	䉲
𥮾	篸
𥯤	𫁳
𥱔	𥵃
𥱸	𬔯
𥳊	𬔹
𥴨	𫂖
𥴼	𫁺
𥵃	𥱔
𥵊	𥭉
𥵚	竻
𥵛	𮅎
𥵜	䇚
𥵝	𬕬
𥸠	𥮋
𥹥	𥼽
𥺅	䊭
𥺇	𥽖
𥺼	𮇔
𥻟	糯
𥻤	𬖖
𥻦	𫂿
𥻵	𬖞
𥼶	𬖘
𥼽	𥹥
𥽖	𥺇
𥽭	𬖺
𥽽	𫧷
𥾂	𮇤
𥾝	𬘔
𥾯	𫄝
𥿉	𬘚
𥿊	𦈈
𥿯	𬘦
𦀇	經
𦀎	𮉥
𦀖	𫄦
𦁄	𰬙
𦁕	𰬦
𦁧	𰬨
𦂅	𦈒
𦂋	𬘸
𦂳	緊
𦃄	𦈗
𦃒	𬘼
𦃘	𬘽
𦃩	𫄯
𦄋	𬘞
𦄍	𬘾
𦄧	𬘿
𦄼	𬘳
𦅇	𫄪
𦅈	𫄵
𦅋	𬙃
𦅘	𰬝
𦅷	𬙅
𦆆	𰬾
𦆈	𰬹
𦆲	𫟇
𦇎	𰭁
𦇛	𰬼
𦈈	𥿊
𦈉	緷
𦈋	綇
𦈌	綀
𦈎	繟
𦈏	緍
𦈐	縺
𦈑	緸
𦈒	𦂅
𦈓	䋿
𦈔	縎
𦈕	緰
𦈖	䌈
𦈗	𦃄
𦈘	䌋
𦈙	䌰
𦈚	縬
𦈛	繓
𦈜	䌖
𦈝	繏
𦈞	䌟
𦈟	䌝
𦈠	䌥
𦈡	繻
𦌾	𬙪
𦍆	𬙫
𦍠	䍽
𦍩	羖
𦎹	𰭚
𦏑	𰭗
𦒀	𫅥
𦔖	𫅼
𦕒	䦓 覘
𦘧	𡳒
𦙵	腕
𦙶	股
𦙼	骴
𦚓	胓
𦚸	𦚹
𦚹	𦚸
𦛨	朥
𦜖	𬁺
𦝼	膢
𦞌	𣎄
𦞛	𬁸
𦞣	臊
𦟐	𬁳
𦟗	𦣎
𦟤	饈
𦟼	𫆝
𦠅	𣎟 𫞅
𦡏	𰗅
𦡖	𰗆
𦡝	𫆫
𦡧	𮌌
𦡶	𰯂
𦢈	𣍨
𦢌	殰
𦣇	𬂂
𦣎	𦟗
𦤎	臯
𦧴	𰰆
𦧺	𫇘
𦨩	𦪽
𦪭	𬜔
𦪽	𦨩
𦬙	𦿍
𦰴	䕳
𦱄	菇
𦱌	𫇪
𦲷	蒞
𦳝	𰰢
𦴇	𦾵
𦵕	𬝖
𦶆	𬜺
𦷝	芻
𦸷	𬝊
𦺣	𰱝
𦻕	蘟
𦽊	驊
𦽒	𬝠
𦾏	𰅻
𦾵	𦴇
𦾶	𬞋
𦿍	𦬙
𧀹	蔗
𧁿	𮏺
𧂅	𬞣
𧃽	𰱊
𧈴	𫋧
𧈿	𬠐
𧉐	𧕟
𧉞	䗿
𧋍	蜇
𧌓	蛗
𧍕	䖼
𧏖	蠙
𧏗	蠀
𧏻	𬠃
𧐅	蛆
𧐐	𰳁
𧐢	蠔
𧐱	𬟺
𧑏	蠾
𧒖	𰲺
𧒭	𧔥
𧒯	𫊹
𧔥	𧒭
𧕟	𧉐
𧕦	𬠷
𧖦	𬠱
𧘂	衝
𧙀	𧞪
𧛸	𬡎
𧜁	𬡕
𧜂	𬡔
𧜗	䘞
𧜡	𧞔
𧜣	𬡍
𧜭	䙱
𧜵	䙊
𧜶	𮖃
𧝝	襰
𧝞	䘛
𧞅	𰳻
𧞔	𧜡
𧞣	𰳹
𧞪	𧙀
𧞫	𫌋
𧞶	𬡦
𧟌	𬡠
𧠈	𬢇
𧠥	𬢉
𧠵	𬢍
𧡍	𬢈
𧡪	𬢏
𧡴	𫌫
𧡸	𰴛
𧢃	𰴚
𧢄	𫌬
𧢍	𬢓
𧢢	𬺟
𧣴	𬢕
𧤤	觹
𧥅	觽
𧥣	𬣚
𧥺	𬣝
𧦝	𫍞
𧦦	𰵘
𧦧	𫍟
𧦭	𬣢
𧧝	𬣨
𧧭	𬣺
𧧵	𰵢
𧧸	𰵬
𧨊	𬣶
𧨝	𰵪
𧨳	𰵳
𧨾	𬤂
𧩕	𫍭
𧩙	誕 䜥
𧩦	𬤅
𧩧	𬤏
𧩪	𬤋
𧩼	𫍶
𧪞	𬤒
𧪡	𬤓
𧪦	𬤕
𧪪	𬤔
𧪮	𰵻
𧫚	𬤈
𧫝	𫍺
𧬁	𰶅
𧬅	𬤜
𧬇	𬤞
𧬌	𬤠
𧬤	𫍼
𧬨	𬣪 噦
𧬪	𬤖
𧬮	𬤧
𧬯	𰶋
𧬻	𬣵
𧭈	𫍾
𧭹	𫍐
𧮆	𬤚
𧮇	𬣴
𧮈	𬤯
𧮓	𬤱
𧮪	詀
𧰆	𬤷
𧰊	磌
𧱻	𰶨
𧳕	𧳟
𧳟	𧳕
𧴪	𭕆
𧴯	孭
𧵊	𬥴
𧵳	䞌
𧶄	𬥷
𧶔	𧹓
𧶟	𬥹
𧶧	䞎
𧶲	𬥼
𧶶	販
𧷎	𪠀
𧷛	𰷨
𧸖	賺 𰷬 贃
𧸘	𫎨
𧸦	𬥾
𧸪	𬥿
𧸫	𫬙
𧹈	𪥠
𧹑	䞈
𧹒	買
𧹓	𧶔
𧹔	賬
𧹕	䝻
𧹖	賟
𧹗	贃
𧺣	𧽵
𧽢	𬦆
𧽯	𫎸
𧽵	𧺣
𧾥	𰷸
𧿈	𨇁
𧿛	蹤
𧿴	跊
𧿹	拇
𨀁	躘
𨀱	𨄣
𨁂	𬦯
𨁴	𨅍
𨂐	𫏌
𨂺	𨈊
𨃘	𬦩
𨃜	𬦹
𨃞	𨃟
𨃟	𨃞
𨄄	𨈌
𨄉	𰸎
𨄣	𨀱
𨄰	𬦵
𨅍	𨁴
𨅛	䠱
𨅫	𨇞
𨅬	躝
𨆅	𬦫
𨆉	𮛗
𨆪	𫏕
𨆱	𬦴
𨇁	𧿈
𨇍	𬧑
𨇗	𬦣
𨇞	𨅫
𨇤	𫏨
𨇯	𰸇
𨇰	𫏞
𨇽	𫏑
𨈀	𬧚
𨈆	𬧛
𨈇	𬦾
𨈊	𨂺
𨈌	𨄄
𨈚	𨉉
𨉉	𨈚
𨉖	𰿰
𨉗	軉
𨉹	𬧩
𨊠	𰹱
𨊰	䢀
𨊸	䢁
𨊹	𰹻
𨊻	𨐆
𨋁	𬨃
𨋚	𬨅
𨋢	䢂
𨋮	𰺆
𨌄	𬨋
𨌈	𫐍
𨌩	逿 盪
𨍈	𰺔
𨍏	𰺕
𨍐	𬨏
𨍒	𰹾
𨍰	𫐔
𨍳	軺
𨍹	𬨐
𨎌	𫐋
𨎩	𬨒
𨎪	𰺚
𨎮	𨐉
𨏒	𰺢
𨏔	𰺌
𨏠	𨐇
𨏥	𨐊
𨐅	軗
𨐆	𨊻
𨐇	𨏠
𨐈	輄
𨐉	𨎮
𨐊	𨏥
𨐶	𰺨
𨑊	𫯒
𨑒	徒
𨑹	䢨
𨘌	𬩎
𨝕	𨞨
𨞨	𨝕
𨞺	𫟫
𨟊	𫟬
𨟳	𨣞
𨠨	𨣧
𨡙	𨢿
𨡺	𨣈
𨢥	䤍
𨢸	𮡈
𨢿	𨡙
𨣃	𰼋
𨣈	𨡺
𨣉	𬪫
𨣞	𨟳
𨣦	藇
𨣧	𨠨
𨣨	𰼏
𨤋	𬪯
𨤡	𬪺
𨤰	𨤻
𨤻	𨤰
𨥛	𨱀
𨥜	𬬴
𨥟	𫓫
𨥦	𬬳
𨥺	𬭂
𨦡	𰽽
𨦫	䦀
𨧀	𬭊
𨧐	𰾇
𨧚	𬭐
𨧜	䦁
𨧫	𬭑
𨧮	䥸
𨧰	𫟽
𨧱	𨱊
𨨏	𬭛
𨨛	𫓼
𨨝	𬭘
𨨢	𫓿
𨨯	𬭟
𨨹	𬭞
𨩨	𬭠
𨩰	𫟾
𨪅	𬇃
𨪋	𰾨
𨪕	𫓮
𨫀	𬭫
𨫒	𨱐
𨫼	𰾧
𨬂	𬭱
𨬒	𰾳
𨬖	𫔏
𨬞	𬬶
𨬟	𰾵
𨭃	𬭷
𨭆	𬭶
𨭌	𬭵
𨭎	𬭳
𨭐	𬭙
𨭖	𫔑
𨭗	𬭇
𨭚	𬭺
𨭛	𰾿
𨭥	𬬼
𨭸	𫔐
𨮁	𰾺
𨮂	𨱕
𨮅	𬭹
𨮰	𬭾
𨮳	𫔒
𨯅	䥿
𨯟	𫔓
𨯵	𬮀
𨰃	𫔉
𨰋	𫓳
𨰠	𰿊
𨰥	𫔕
𨰭	𬮃
𨰲	𫔃
𨰵	𬬇
𨰷	𬮂
𨰹	𰿀
𨰾	鎷
𨰿	釳
𨱀	𨥛
𨱁	鈠
𨱂	鈋
𨱃	鈲
𨱄	鈯
𨱅	鉁
𨱆	龯
𨱇	銶
𨱈	鋉
𨱉	鍄
𨱊	𨧱
𨱋	錂
𨱌	鏆
𨱍	鎯
𨱎	鍮
𨱏	鎝
𨱐	𨫒
𨱑	鐄
𨱒	鏉
𨱓	鐎
𨱔	鐏
𨱕	𨮂
𨱖	䥩
𨱥	𰿖
𨲭	𬮄
𨲳	𫔖
𨳌	𰿦
𨳐	𰿧
𨳑	𨸁
𨳒	𮤭
𨳕	𨸀
𨳙	𮤯
𨳚	𰿪
𨳨	𬮜
𨳸	𰿭
𨳿	𬮡
𨴑	𬮣
𨴗	𨸅
𨴤	𬮧
𨴹	𫔲
𨵆	𬮩
𨵌	𬮰
𨵗	𬮯
𨵤	𬮮
𨵦	𰿵
𨵩	𨸆
𨵬	𬮵
𨵸	𨸇
𨶀	𨸉
𨶏	𨸊
𨶑	𰿸
𨶮	𨸌
𨶯	𮤸
𨶰	𰿹
𨶲	𨸋
𨶹	関
𨶻	𬮸
𨶿	𬮹
𨷈	𬮙
𨷲	𨸎
𨷻	𫔱
𨷿	䦳
𨸀	𨳕
𨸁	𨳑
𨸂	閍
𨸃	閐
𨸄	䦘
𨸅	𨴗
𨸆	𨵩
𨸇	𨵸
𨸉	𨶀
𨸊	𨶏
𨸋	𨶲
𨸌	𨶮
𨸎	𨷲
𨸘	𨽏
𨸚	級
𨸟	䧢
𨸬	陣
𨻲	罅
𨻹	𨽈
𨼳	𫔽
𨽈	𨻹
𨽏	𨸘
𩀨	𫕚
𩅙	𫕨
𩅦	𱁞
𩅾	𫡶
𩇉	𮦚
𩇝	濪
𩉍	𬰣
𩉙	𬰡
𩋌	𱁱
𩋘	鞋
𩋧	鞋
𩋰	𬰤
𩍜	𱁳
𩎒	𬰱
𩎕	𱂃
𩎖	𫖑
𩎟	𱂄
𩎠	𬰴
𩎢	𩏾
𩏂	𫖓
𩏌	𬰵
𩏠	𫖖
𩏪	𩏽
𩏴	𬰸
𩏷	𫃗
𩏼	䪏
𩏽	𩏪
𩏾	𩎢
𩏿	䪘
𩐀	䪗
𩐌	𱂍
𩑃	𬰺
𩑒	𱂠
𩑔	𫖪
𩑡	𱂡
𩑣	𬱔
𩑦	𬱕
𩑵	𩑷
𩑷	𩑵
𩒎	𫖭
𩒜	𬱡
𩒝	𬱝
𩒲	𬱤
𩒺	𱂩
𩒼	𬱥
𩓣	𩖕
𩓥	𫖵
𩓸	𬱧
𩓹	𬱨
𩔇	𱂳
𩔈	𬱭
𩔊	𬱛
𩔑	𫖷
𩔗	類
𩔣	𱂷
𩔳	𫖴
𩕊	𬱱
𩕰	𬱲
𩖁	𬺂
𩖕	𩓣
𩖖	顃
𩖗	䫴
𩖰	𫠇
𩖿	𬱺
𩗀	𩙦
𩗓	𫗈
𩗛	𱃛
𩗡	𩙧
𩗴	𫗉
𩘀	𩙩
𩘚	𬰲
𩘝	𩙭
𩘹	𩙨
𩘺	𩙬
𩘻	𬲆
𩙈	𩙰
𩙥	颰
𩙦	𩗀
𩙧	𩗡 䬞
𩙨	𩘹
𩙩	𩘀
𩙪	颷
𩙫	颾
𩙬	𩘺
𩙭	𩘝
𩙮	䬘
𩙯	䬝
𩙰	𩙈
𩚅	𬲥
𩚚	𬲩
𩚛	𩟿
𩚥	𩠀
𩚩	𫗡
𩚵	𩠁
𩛆	𩠂
𩛌	𫗤
𩛎	𬲴
𩛞	𬲺
𩛡	𫗨
𩛩	𩠃
𩛲	𬲹
𩜇	𩠉
𩜠	𬲿
𩜦	𩠆
𩜯	𱄂
𩜰	𬳃
𩜵	𩠊
𩜶	𱄁
𩝑	𬳇
𩝔	𩠋
𩝠	𬳌
𩝡	𬳈
𩝣	𬳉
𩝧	𱄅
𩝽	𫗳
𩞃	𬲰
𩞄	𩠎
𩞆	𬲪
𩞉	𬳐
𩞡	𬲬
𩞦	𩠏
𩞧	𱄇
𩞬	𬳒
𩞯	䭪
𩟀	𬳓
𩟂	𬲸
𩟐	𩠅
𩟗	𫗚
𩟠	𬳔
𩟿	𩚛
𩠀	𩚥
𩠁	𩚵
𩠂	𩛆
𩠃	𩛩
𩠅	𩟐
𩠆	𩜦
𩠇	䭀
𩠈	䭃
𩠉	𩜇
𩠊	𩜵
𩠋	𩝔
𩠌	餸
𩠎	𩞄
𩠏	𩞦
𩠑	頂
𩠠	𩠴
𩠴	𩠠
𩡖	𩡣
𩡚	𩡤
𩡣	𩡖
𩡤	𩡚
𩡺	𩧦
𩢍	𬳷
𩢡	𩧬
𩢰	𱅎
𩢲	駛 𬳺
𩢴	𩧵
𩢸	𩧳
𩢼	𬳻
𩢾	𩧮
𩣊	𱅍
𩣋	𬳼
𩣏	𩧶
𩣑	䯃
𩣔	𬳹
𩣡	𱅓
𩣫	𩧸
𩣵	𩧻
𩣺	𩧼
𩤊	𩧩
𩤙	𩨆
𩤲	𩨉
𩤵	𬴄
𩤸	𩨅
𩥃	𱅥
𩥄	𩨋
𩥅	𱅣
𩥇	𩨍
𩥉	𩧱
𩥎	𱅨
𩥑	𩨌
𩥲	𬴇
𩥼	𬴈
𩦃	𱅘
𩦚	𬴉
𩦠	𫠌
𩦢	虞
𩦺	𬴌
𩧆	𩨐
𩧉	𱄾
𩧐	𬴎
𩧢	𱅒
𩧦	𩡺
𩧨	駎
𩧩	𩤊
𩧪	䮾
𩧫	駚
𩧬	𩢡
𩧭	䭿
𩧮	𩢾
𩧯	驋
𩧰	䮝
𩧱	𩥉
𩧲	駧
𩧳	𩢸
𩧴	駩
𩧵	𩢴
𩧶	𩣏
𩧸	𩣫
𩧺	駶
𩧻	𩣵
𩧼	𩣺
𩧿	䮠
𩨀	騔
𩨁	䮞
𩨃	騝
𩨄	騪
𩨅	𩤸
𩨆	𩤙
𩨇	䮫
𩨈	騟
𩨉	𩤲
𩨊	騚
𩨋	𩥄
𩨌	𩥑
𩨍	𩥇
𩨎	龭
𩨏	䮳
𩨐	𩧆
𩨘	胳 肐
𩩈	䯤
𩬣	𩭙
𩬤	𩰀
𩬾	𩭯
𩭙	𩬣
𩭯	𩬾
𩭹	鬖
𩯁	𫙂
𩯃	𱆄
𩯆	𬴨
𩯒	𩯳
𩯭	鬓
𩯳	𩯒
𩰀	𩬤
𩰰	𩰹
𩰹	𩰰
𩱈	𱆍
𩲒	𩳤
𩳤	𩲒
𩴆	𱆖
𩴌	𩴵
𩴵	𩴌
𩵚	𬶂
𩵦	𫠏
𩵩	𩽺
𩵱	𬶉
𩵹	𩽻
𩵺	𬶈
𩶀	𬶅
𩶁	𫚎
𩶘	䲞
𩶯	𱇫
𩶰	𩽿
𩶱	𩽽
𩷒	𬶒
𩷰	𩾄
𩷶	𱇮
𩸃	𩾅
𩸄	𫚝
𩸆	𬶖
𩸡	𫚟
𩸣	𬶙
𩸤	𬶚
𩸦	𩾆
𩸩	𬶝
𩸬	𬶜
𩹂	𱈃
𩹊	𬶦
𩹝	𬶡
𩹽	𬶩
𩹾	𱇴
𩺝	𬶪
𩺞	𱈎
𩻗	𫚨
𩻛	𱈔
𩻧	𬶯
𩻬	𫚩
𩻮	𫚘
𩻰	𬶰
𩻱	𬶱
𩼔	𬶶
𩼶	𫚬
𩽅	𬶸
𩽇	𩾎
𩽈	𬶳
𩽔	𬶹
𩽷	𬶻
𩽹	魥
𩽺	𩵩
𩽻	𩵹
𩽼	鯶
𩽽	𩶱
𩽾	鮟
𩽿	𩶰
𩾁	鯄
𩾂	䲖
𩾃	鮸
𩾄	𩷰
𩾅	𩸃
𩾆	𩸦
𩾇	鯱
𩾈	䱙
𩾊	䱬
𩾋	䱰
𩾌	鱇
𩾎	𩽇
𩾐	𬷻
𩾒	𬷽
𩾝	𱉋
𩿅	𫠖
𩿊	𱉒
𩿣	𩿲
𩿤	𫛠
𩿧	𱉜
𩿪	𪉄
𩿱	𬸃
𩿲	𩿣
𩿺	𬸁
𪀉	𬸂
𪀖	𫛧
𪀗	𱉭
𪀚	𱉣
𪀛	𬸉
𪀦	𪉅
𪀻	𬸋
𪀾	𪉋
𪁈	𪉉
𪁏	𮭦
𪁐	𬸎
𪁑	𬸑
𪁖	𪉌
𪁛	𱉷
𪁜	𬸏
𪁱	𬸐
𪁿	𬸔
𪂆	𪉎
𪂈	𬸖
𪂩	𬸗
𪂫	𬸓
𪃃	𱊔
𪃍	𪉐
𪃏	𪉏
𪃒	𫛻
𪃦	𬸙
𪃧	𫛹
𪃮	𬸟
𪃿	𬸠
𪄅	𬸌
𪄆	𪉔
𪄕	𪉒
𪄠	𱊞
𪄲	𱊥
𪅂	𫜂
𪅃	𬸤
𪅖	𬸥
𪅜	𬷿
𪅾	𬸨
𪆃	𬸫
𪆫	𱊨
𪆰	𬸭
𪆴	𬸮
𪆷	𫛾
𪇄	𬸬
𪇖	𬸡
𪇘	𬸍
𪇰	𱊲
𪇳	𪉕
𪈏	𱊴
𪈔	𱊉
𪈗	𬸄
𪈼	𱊜
𪉂	䲰
𪉃	鳼
𪉄	𩿪
𪉅	𪀦
𪉆	鴲
𪉈	鴜
𪉉	𪁈
𪉊	鷨
𪉋	𪀾
𪉌	𪁖
𪉍	鵚
𪉎	𪂆
𪉏	𪃏
𪉐	𪃍
𪉑	鷔
𪉒	𪄕
𪉔	𪄆
𪉕	𪇳
𪉖	𱊺
𪉜	𬸵
𪉣	𱊻
𪉨	𬸶
𪉮	𬸷
𪉱	𬸸
𪉸	𫜊
𪉿	𬸹
𪊉	𱊽
𪋈	𱋂
𪋼	𱋅
𪋽	𱋄
𪋿	𫧮
𪌐	𱋉
𪌒	𮮅
𪌗	𱋌
𪌘	𱋍
𪌜	𪽂
𪌣	𱋓
𪌨	𰎴
𪌬	𱋕
𪌭	𫜓
𪌮	𱋘
𪌯	𬹈
𪌰	𬹇
𪌽	𬹋
𪌾	𱋚
𪌿	𬹌
𪍀	𬹊
𪍇	𱋜
𪍍	𱋠
𪍑	𱋢
𪍒	𱋟
𪍓	𱋥
𪍘	𱋤
𪍚	𱋣
𪍞	𱋦
𪍠	𫜕
𪍣	𱋡
𪍤	𬹍
𪍬	𱋨
𪍴	𱋬
𪍶	𬹎
𪍷	𱋑
𪍿	𱋈
𪎂	𱋭
𪎈	䴬
𪎉	麲
𪎊	麨
𪎋	䴴
𪎌	麳
𪑅	䵳
𪑚	𬹗
𪑳	𬹕
𪒬	𬹖
𪒿	𬹘
𪓛	𱌀
𪓬	𱌅
𪓰	𫜟
𪓹	𱌈
𪓽	𬹤
𪔂	鼎
𪔭	𪔵
𪔵	𪔭
𪕣	𬹭
𪖙	齁
𪖨	𱌕
𪗋	𱌙
𪗜	𬹽
𪗝	𬹻
𪗪	𬹿
𪗭	𬺀
𪗳	𬹾
𪗻	𬺁
𪗽	𬺄
𪘀	𪚏
𪘅	𰳆
𪘓	𬺇
𪘞	𬺆
𪘥	𱌸
𪘧	𬺋
𪘨	𱌴
𪘩	𬺊
𪘬	𱌷
𪘯	𪚐
𪘲	𬺌
𪙉	𱌼
𪙍	𬺏
𪙏	𫜯
𪙑	𬺑
𪙕	𬺐
𪙞	𬺅
𪙤	𬺒
𪚅	𬺖
𪚏	𪘀
𪚐	𪘯
𪚔	𬺛
𪚣	𬺝
𪚭	𱍅
𪚮	𱍄
𪚰	𱍆
𪛕	𱍉
𪜎	𠿕
𪜺	𰂠
𪝖	𫢟
𪝵	𰂁
𪞝	凙
𪟎	㔋
𪟖	𠛾
𪟝	勣
𪟲	𫧝
𪠀	𧷎
𪠃	𫨑
𪠏	𥀬
𪠟	㓄
𪠡	𠬙
𪠳	唓
𪠵	㖮
𪠸	嚛
𪠽	噹
𪡀	嘺
𪡃	嘪
𪡋	噞
𪡏	嗹
𪡛	㗿
𪡞	嘳
𪡺	𡃄
𪢈	𢖕
𪢋	𰉀
𪢌	㘓
𪢍	𭉗
𪢐	𡃤
𪢒	𡂡
𪢕	嚽
𪢠	囒
𪢥	𫩸
𪢮	圞
𪣆	埬
𪣒	堚
𪣻	塿
𪤄	𡓁
𪤅	𰋆
𪤚	壣
𪥠	𧹈
𪥫	孇
𪥰	嬣
𪥿	嬻
𪧀	孾
𪧘	寠
𪨇	尵
𪨊	㞞
𪨗	屩 𫏋
𪨧	崙
𪨩	𡸗
𪨶	輋
𪨷	巗
𪨹	𡹬
𪩇	㟺
𪩎	巊
𪩘	巘
𪩛	𡿖
𪩸	幩
𪪑	㢗
𪪝	雝 邕 雍
𪪞	廧
𪪴	𢍰
𪫌	徿
𪫡	𢤩
𪫷	㦞
𪫸	𢜭
𪫺	憸
𪬚	𢣐
𪬯	𢤿
𪭝	𢯷
𪭢	摐
𪭧	擟
𪭯	𢶒
𪭵	掚
𪭾	撊
𪮃	㨻
𪮋	㩋
𪮖	撧
𪮰	𫼽
𪮳	𢺳
𪮶	攋
𪯂	𭡆
𪯋	㪎
𪰶	曊
𪱥	膹
𪱷	梖
𪲎	櫅
𪲔	欐
𪲛	檵
𪲮	櫠
𪳍	欇
𪳷	𬂱
𪴙	欑
𪴥	𬃏
𪴯	歞
𪵇	𰚂
𪵑	毊
𪵢	𰚬
𪵣	霼
𪵱	濿
𪶄	溡
𪶒	𤄷
𪶮	𣽏
𪷈	𭱀
𪷍	㵾
𪷽	灒
𪸕	熂
𪸩	煇
𪹀	𤑹
𪹠	𤓌
𪹳	爥
𪹹	𤒻
𪺣	𤘀
𪺪	𤜆
𪺭	犞
𪺷	獊
𪺸	𤠮
𪺻	㺜
𪺽	猌
𪻐	瑽
𪻨	瓄
𪻲	瑻
𪻺	璝
𪼋	㻶
𪼴	𤬅
𪽂	𪌜
𪽝	𤳷
𪽪	痮
𪽭	𤷃
𪽮	㿖
𪽴	𤺔
𪽷	瘱
𪾔	盨
𪾢	睍
𪾦	矑
𪾸	矉
𪿊	𥏝
𪿞	𥖲
𪿫	礮
𪿵	𥗇
𫀌	𥜰
𫀓	𥜐
𫀨	䅐
𫀬	䅳
𫀮	𥢷
𫁂	䆉
𫁟	竱
𫁡	鴗
𫁲	䉑
𫁳	𥯤
𫁷	䉶
𫁺	𥴼
𫂃	簢
𫂆	簂
𫂈	䉬
𫂖	𥴨
𫂿	𥻦
𫃐	𬖟
𫃑	𰪿
𫃗	𩏷
𫃞	𰫿
𫃥	𮉩
𫃷	𮉭
𫄇	𬘹
𫄙	糺
𫄚	䊺
𫄛	紟
𫄜	䋃
𫄝	𥾯
𫄞	䋔
𫄟	絁
𫄠	絙
𫄡	絧
𫄢	絥
𫄣	繷
𫄤	繨
𫄥	纚
𫄦	𦀖
𫄧	綖
𫄨	絺
𫄩	䋦
𫄪	𦅇
𫄫	綟
𫄬	緤
𫄭	緮
𫄮	䋼
𫄯	𦃩
𫄰	縍
𫄱	繬
𫄲	縸
𫄳	縰
𫄴	繂
𫄵	𦅈
𫄶	繈
𫄷	繶
𫄸	纁
𫄹	纗
𫅅	䍤
𫅗	羵
𫅥	𦒀
𫅭	䎙
𫅼	𦔖
𫆏	聻
𫆝	𦟼
𫆫	𦡝
𫇘	𦧺
𫇠	𮎍
𫇪	𦱌
𫇭	蒍
𫇴	蒭
𫇽	蕽
𫈉	蕳
𫈎	葝
𫈟	蔯
𫈵	蕝
𫈹	𰰿
𫉁	薆
𫉄	藷
𫉍	𮏀
𫊪	䗅
𫊮	蠦
𫊱	蠒
𫊸	蟜
𫊹	𧒯
𫊻	蟳
𫋇	蟂
𫋌	蟘
𫋐	𬠈
𫋧	𧈴
𫋲	䙔
𫋷	襗
𫋹	襓
𫋻	襘
𫌀	襀
𫌇	襵
𫌋	𧞫
𫌙	𬡱
𫌨	覼
𫌩	𰴏
𫌪	覛
𫌫	𧡴
𫌬	𧢄
𫌭	覹
𫌯	䚩
𫍏	𫍘
𫍐	𧭹
𫍘	𫍏
𫍙	訑
𫍚	訞
𫍛	訜
𫍜	詓
𫍞	𧦝
𫍟	𧦧
𫍠	䛄
𫍡	詑
𫍢	譊
𫍣	詷
𫍤	譑
𫍥	誂
𫍦	譨
𫍧	誺
𫍨	誫
𫍩	諣
𫍪	誋
𫍫	䛳
𫍬	誷
𫍭	𧩕
𫍮	誳
𫍯	諴
𫍰	諰
𫍱	諯
𫍲	謏
𫍳	諥
𫍴	謱
𫍵	謸
𫍶	𧩼
𫍷	謉
𫍸	謆
𫍹	謯
𫍺	𧫝
𫍻	譆
𫍼	𧬤
𫍽	譞
𫍾	𧭈
𫍿	譾
𫎆	豵
𫎌	貗
𫎦	贚
𫎧	䝭
𫎨	𧸘
𫎩	賝
𫎪	䞋
𫎫	贉
𫎬	贑
𫎭	䞓
𫎱	䟐
𫎳	䟆
𫎸	𧽯
𫎺	䟃
𫏃	䠆
𫏆	蹳
𫏋	𪨗 蹻
𫏌	𨂐
𫏐	蹔
𫏑	𨇽
𫏕	𨆪
𫏞	𨇰
𫏨	𨇤
𫐄	軏
𫐅	軕
𫐆	轣
𫐇	軜
𫐈	軷
𫐉	軨
𫐊	軬
𫐋	𨎌
𫐌	軿
𫐍	𨌈
𫐎	輢
𫐏	輖
𫐐	輗
𫐑	輨
𫐒	輷
𫐓	輮
𫐔	𨍰
𫐕	轊
𫐖	轇
𫐗	轐
𫐘	轗
𫐙	轠
𫐷	遱
𫑘	鄟
𫑡	鄳
𫑷	醶
𫒞	𬭋
𫒡	𫓷
𫒢	𰾉
𫒷	𰾣
𫓥	釟
𫓦	釨
𫓧	鈇
𫓨	鈛
𫓩	鏦
𫓪	鈆
𫓫	𨥟
𫓬	鉔
𫓭	鉠
𫓮	𨪕
𫓯	銈
𫓰	銊
𫓱	鐈
𫓲	銁
𫓳	𨰋
𫓴	鉾
𫓵	鋠
𫓶	鋗
𫓷	𫒡
𫓸	錽
𫓹	錤
𫓺	鐪
𫓻	錜
𫓼	𨨛
𫓽	錝
𫓾	錥
𫓿	𨨢
𫔀	鍊
𫔁	鐼
𫔂	鍉
𫔃	𨰲
𫔄	鍒
𫔅	鎍
𫔆	䥯
𫔇	鎞
𫔈	鎙
𫔉	𨰃
𫔊	鏥
𫔋	䥗
𫔌	鏾
𫔍	鐇
𫔎	鐍
𫔏	𨬖
𫔐	𨭸
𫔑	𨭖
𫔒	𨮳
𫔓	𨯟
𫔔	鑴
𫔕	𨰥
𫔖	𨲳
𫔘	𰿥
𫔡	𰿯
𫔭	開
𫔯	閗
𫔰	閞
𫔱	𨷻
𫔲	𨴹
𫔴	閵
𫔵	䦯
𫔶	闑
𫔽	𨼳
𫕚	𩀨
𫕥	霣
𫕨	𩅙
𫖃	靧
𫖅	䪊
𫖇	鞾
𫖑	𩎖
𫖒	韠
𫖓	𩏂
𫖔	韛
𫖕	韝
𫖖	𩏠
𫖞	𬱘
𫖪	𩑔
𫖫	䪴
𫖬	䪾
𫖭	𩒎
𫖮	顗
𫖯	頫
𫖰	䫂
𫖱	䫀
𫖲	䫟
𫖳	頵
𫖴	𩔳
𫖵	𩓥
𫖶	顅
𫖷	𩔑
𫖸	願
𫖹	顣
𫖺	䫶
𫗇	䫻
𫗈	𩗓
𫗉	𩗴
𫗊	䬓
𫗋	飋
𫗑	𬲵
𫗕	𬳄
𫗚	𩟗
𫗞	飦
𫗟	䬧
𫗠	餦
𫗡	𩚩
𫗢	飵
𫗣	飶
𫗤	𩛌
𫗥	餫
𫗦	餔
𫗧	餗
𫗨	𩛡
𫗩	饠
𫗪	餧
𫗫	餬
𫗬	餪
𫗭	餵
𫗮	餭
𫗯	餱
𫗰	䭔
𫗱	䭑
𫗲	𬲛
𫗳	𩝽
𫗴	饘
𫗵	饟
𫗻	𬳙
𫘛	馯
𫘜	馼
𫘝	駃
𫘞	駞
𫘟	駊
𫘠	駤
𫘡	駫
𫘣	駻
𫘤	騃
𫘥	騉
𫘦	騊
𫘧	騄
𫘨	騠
𫘩	騜
𫘪	騵
𫘫	騴
𫘬	騱
𫘭	騻
𫘮	䮰
𫘯	驓
𫘰	驙
𫘱	驨
𫘽	鬠
𫙂	𩯁
𫚈	鱮
𫚉	魟
𫚊	鰑
𫚋	鱄
𫚌	魦
𫚍	魵
𫚎	𩶁
𫚏	䱁
𫚐	䱀
𫚑	鮅
𫚒	鮄
𫚓	鮤
𫚔	鮰
𫚕	鰤
𫚖	鮆
𫚗	鮯
𫚘	𩻮
𫚙	鯆
𫚚	鮿
𫚛	鮵
𫚜	䲅
𫚝	𩸄
𫚞	鯬
𫚟	𩸡
𫚠	䱧
𫚡	鯞
𫚢	鰋
𫚣	鯾
𫚤	鰦
𫚥	鰕
𫚦	鰫
𫚧	鰽
𫚨	𩻗
𫚩	𩻬
𫚪	鱊
𫚫	鱢
𫚬	𩼶
𫚭	鱲
𫛚	鳽
𫛛	鳷
𫛜	鴀
𫛝	鴅
𫛞	鴃
𫛟	鸗
𫛠	𩿤
𫛡	鴔
𫛢	鸋
𫛣	鴥
𫛤	鴐
𫛥	鵊
𫛦	鴮
𫛧	𪀖
𫛨	鵧
𫛩	鴳
𫛪	鴽
𫛫	鶰
𫛬	䳜
𫛭	鵟
𫛮	䳤
𫛯	鶭
𫛰	䳢
𫛱	鵫
𫛲	鵰
𫛳	鵩
𫛴	鷤
𫛵	鶌
𫛶	鶒
𫛷	鶦
𫛸	鶗
𫛹	𪃧
𫛺	䳧
𫛻	𪃒
𫛼	䳫
𫛽	鷅
𫛾	𪆷
𫜀	鷐
𫜁	鷩
𫜂	𪅂
𫜃	鷣
𫜄	鷷
𫜅	䴋
𫜊	𪉸
𫜑	麷
𫜒	䴱
𫜓	𪌭
𫜔	䴽
𫜕	𪍠
𫜙	䵴
𫜟	𪓰
𫜦	𫜫
𫜨	䶕
𫜩	齧
𫜪	齩
𫜫	𫜦
𫜬	齰
𫜭	齭
𫜮	齴
𫜯	𪙏
𫜰	齾
𫜲	龓
𫜳	䶲
𫝈	㑮
𫝋	𠐊
𫝜	𠱞
𫝡	𡓗
𫝦	㛝
𫝧	㜐
𫝨	媈
𫝩	嬦
𫝪	𡟫
𫝫	婡
𫝬	嬇
𫝭	孆
𫝮	孄
𫝵	嶹
𫞅	𦠅
𫞗	潣
𫞚	澬
𫞛	㶆
𫞝	灍
𫞠	爧
𫞡	爃
𫞢	𤛱
𫞣	㹽
𫞥	珼
𫞦	璾
𫞧	𤩂
𫞨	璼
𫞩	璊
𫞷	𥢶
𫟃	絍
𫟄	綋
𫟅	綡
𫟆	緟
𫟇	𦆲
𫟑	䖅
𫟕	䕤
𫟞	訨
𫟟	詊
𫟠	譂
𫟡	誴
𫟢	䜖
𫟤	䡐
𫟥	䡩
𫟦	䡵
𫟫	𨞺
𫟬	𨟊
𫟲	釚
𫟳	釲
𫟴	鈖
𫟵	鈗
𫟶	銏
𫟷	鉝
𫟸	鉽
𫟹	鉷
𫟺	䤤
𫟻	銂
𫟼	鐽
𫟽	𨧰
𫟾	𨩰
𫟿	鎈
𫠀	䥄
𫠁	鑉
𫠂	閝
𫠅	韚
𫠆	頍
𫠇	𩖰
𫠈	䫾
𫠊	䮄
𫠋	騼
𫠌	𩦠
𫠏	𩵦
𫠐	魽
𫠑	䱸
𫠒	鱆
𫠖	𩿅
𫠜	齯
𫡬	𠷏
𫡶	𩅾
𫢒	儱
𫢔	𠐽
𫢘	𠏮
𫢙	働
𫢜	𰂴
𫢟	𪝖
𫢨	𠎒
𫢪	僆
𫢬	僗
𫢭	儰
𫢲	𫣴
𫢸	僤
𫢹	𠑙
𫢺	傪
𫣉	儖
𫣊	僾
𫣛	𠑲
𫣫	𠐍
𫣴	𫢲
𫤸	㝟
𫤽	𠖫
𫥍	𠘥
𫥔	𫥝
𫥝	𫥔
𫥳	𠠝
𫥵	𠠏
𫥺	𠟪
𫥼	𠜲
𫥽	𫦙
𫦁	𠝿
𫦅	㔅
𫦉	𠞭
𫦋	𫦔
𫦌	㔃
𫦔	𫦋
𫦙	𫥽
𫦩	㔝
𫦰	𫦸
𫦳	㔢
𫦸	𫦰
𫧃	𣍐
𫧝	𪟲
𫧮	𪋿
𫧯	卨
𫧷	𥽽
𫧿	贕
𫨆	𠩘
𫨑	𪠃
𫩕	嚝
𫩖	𠵘
𫩚	𠵹
𫩛	㗰
𫩤	㗼
𫩥	嚿
𫩩	㗙
𫩫	嚈
𫩯	𠹛
𫩳	𠼮
𫩸	𪢥
𫩺	嚍
𫪀	㗻
𫪁	唻
𫪂	㘙
𫪃	囇
𫪄	𠼤
𫪅	𠺮
𫪑	𰈝
𫪘	𡂿
𫪚	𠼗
𫪛	𭇉
𫪧	嘄
𫪪	𡂒
𫪺	㗣
𫪽	𠾬
𫫇	噁
𫫏	𫬆
𫫦	嚪
𫫵	𡀿
𫫾	嚬
𫬆	𫫏
𫬐	㘔
𫬙	𧸫
𫬟	𡅥
𫬱	𰇥
𫭞	塼
𫭟	塸
𫭢	埨
𫭨	墢
𫭪	墝
𫭮	𡍫
𫭯	𡑎
𫭲	壧
𫭼	𡑍
𫮃	墠
𫮅	墋
𫮜	㙬
𫯒	𨑊
𫯓	𬻮
𫯥	奯
𫯶	奫
𫰂	奲
𫰍	媁
𫰛	娙
𫰠	㜭
𫰡	嬅
𫰢	嬒
𫰣	𡤠
𫰨	㜥
𫰰	嬐
𫰹	嫢
𫱕	㜮
𫱿	𡤫
𫲗	㜺
𫲴	𭓀
𫲸	寷
𫳃	㝞
𫴼	𡮤
𫵵	崵
𫵶	𡺨
𫵷	㠣
𫵸	𡷨
𫵹	𡽵
𫶄	𫶦
𫶅	㠁
𫶇	嵽
𫶊	𡽳
𫶕	巆
𫶦	𫶄
𫶲	𣫒
𫷅	㡓
𫷈	𢄼
𫷉	幰
𫷌	𢅡
𫷘	𠁔
𫷬	庲
𫷮	廕
𫷷	廞
𫷹	廔
𫷾	廮
𫸩	彄
𫹮	懙
𫹴	愇
𫹷	𢥠
𫹼	𢛔
𫹽	慯
𫺁	㤲
𫺂	悏
𫺆	㦊
𫺊	懠
𫺌	愩
𫺒	𢢀
𫺓	㦖
𫺘	憦
𫺪	懩
𫺫	𢤜
𫺷	戁
𫺹	𫻑
𫻁	㦦
𫻇	𢤌
𫻑	𫺹
𫼗	𢲫
𫼝	搊
𫼣	𢳂
𫼤	𢯩
𫼥	㨟
𫼧	撶
𫼫	𢲾
𫼮	擃
𫼱	摃
𫼲	𢯦
𫼵	𢲸
𫼶	𢱡
𫼽	𪮰
𫼾	𢲩
𫽀	㨥
𫽁	摙
𫽇	㩇
𫽊	㩭
𫽋	攞
𫽐	𢳚
𫽔	𢷃
𫽙	𢴦
𫽢	𰔺
𫽣	摪
𫽥	攑
𫽧	㩌
𫽫	𰔫
𫽮	擋 攩
𫽲	𢶑
𫽳	𢴩
𫾁	𢸴
𫾃	𢸳
𫾉	㩣
𫾏	𫾡
𫾡	𫾏
𫾲	𣀷
𫾳	𣀘
𫿂	𢿓
𫿗	𣀻
𬀥	𣄸
𬀩	暐
𬀪	晛
𬀮	㬣
𬀱	暟
𬁑	𣌂
𬁘	𰖻
𬁳	𦟐
𬁵	膒
𬁸	𦞛
𬁺	𦜖
𬁽	䐣
𬂀	膶
𬂂	𦣇
𬂅	䐷
𬂉	賸
𬂠	橅
𬂩	梜
𬂮	榝
𬂰	檂
𬂱	𪳷
𬂻	𣛣
𬃀	槻
𬃊	櫍
𬃏	𪴥
𬃘	樲
𬃛	𬄝
𬃦	𣚙
𬃫	櫶
𬃮	𣙿
𬃲	䫐
𬃳	𣡶
𬄝	𬃛
𬄞	𣠕
𬄩	櫽
𬄬	𣡌
𬅢	㰰
𬅥	歄
𬅫	歕
𬆂	𬆉
𬆉	𬆂
𬆙	𣩕
𬆦	毄
𬆮	鷇
𬆾	覒
𬇃	𨪅
𬇄	𣰨
𬇇	㲲
𬇕	澫
𬇘	漙
𬇙	浿
𬇬	𤅙
𬇰	㵍
𬇹	漍
𬇼	𣻏
𬈁	潬
𬈏	𬉤
𬈕	㵒
𬈧	濇
𬈱	𤀪
𬈾	𤁪
𬉂	瀵
𬉇	㵤
𬉋	瀢
𬉠	灡
𬉤	𬈏
𬉼	熰
𬊂	煼
𬊈	燖
𬊉	燵
𬊍	燽
𬊎	熕
𬊖	燘
𬊗	𤍖
𬊜	𤓓
𬊤	燀
𬊦	覢
𬊵	爣
𬊶	爁
𬊺	燰
𬊾	㸐
𬋃	𤒦
𬋍	㸊
𬌝	犓
𬌠	𬌦
𬌦	𬌠
𬌮	獟
𬌴	𤣤
𬌵	𬍁
𬌷	㺑
𬍁	𬌵
𬍙	琖
𬍛	瓅
𬍡	璗
𬍤	璕
𬎆	㼆
𬎑	瓓
𬎧	㼻
𬎬	𤮦
𬏜	㾺
𬏟	㾵
𬏤	𤻲
𬏦	癈
𬏫	瘒
𬏮	瘑
𬏲	𰣢
𬏷	㿎
𬐠	𥂸
𬑆	睔
𬑇	𥇔
𬑍	𬑡
𬑏	䀴
𬑒	䁱
𬑓	瞱
𬑕	睴
𬑗	瞷
𬑙	𥌚
𬑡	瞅 矁 𬑍
𬑧	矊
𬒄	𬒒
𬒆	礏
𬒇	𥗺
𬒈	礐
𬒊	𥖩
𬒍	磒
𬒎	䃘
𬒒	𬒄
𬒓	𥗴
𬒕	䃤
𬒗	𥗽
𬓠	穖
𬓡	𠂲
𬓫	龝
𬓱	𥢊
𬓸	䵘
𬓼	穨
𬔯	𥱸
𬔹	𥳊
𬕂	篢
𬕄	籭
𬕊	䉍
𬕛	䉐
𬕦	䉱
𬕬	𥵝
𬖃	籫
𬖑	粯
𬖖	𥻤
𬖘	𥼶
𬖞	𥻵
𬖟	𫃐
𬖠	㪹
𬖮	糮
𬖺	𥽭
𬗏	𬘣
𬗺	𬙀
𬘓	紃
𬘔	𥾝
𬘕	紌
𬘖	絸
𬘗	𰫛
𬘘	紞
𬘙	䋐
𬘚	𥿉
𬘛	紶
𬘜	䋎
𬘝	紾
𬘞	𦄋
𬘟	絤
𬘠	絠
𬘡	絪
𬘢	絖
𬘣	𬗏
𬘤	絽
𬘥	絟
𬘦	𥿯
𬘧	纃
𬘨	綕
𬘩	綎
𬘪	䌞
𬘫	綄
𬘬	綪
𬘭	綝
𬘮	䌐
𬘯	綧
𬘰	緛
𬘱	䌁
𬘲	䋾
𬘳	𦄼
𬘴	䋺
𬘵	緪
𬘶	緧
𬘷	縒
𬘸	𦂋
𬘹	𫄇
𬘺	縚
𬘻	縖
𬘼	𦃒
𬘽	𦃘
𬘾	𦄍
𬘿	𦄧
𬙀	𬗺
𬙁	䌪
𬙂	縯
𬙃	𦅋
𬙄	𰫳
𬙅	𦅷
𬙆	繙
𬙇	繎
𬙈	繗
𬙉	繵
𬙊	纆
𬙋	纕
𬙎	罏
𬙏	𬙔
𬙔	𬙏
𬙝	罼
𬙪	𦌾
𬙫	𦍆
𬙭	䍷
𬚄	䎘
𬛕	𣘾
𬛹	䑗
𬛼	轝
𬜔	𦪭
𬜥	葻
𬜧	蕟
𬜨	薉
𬜬	蔄
𬜯	䓣
𬜸	蘹
𬜺	𦶆
𬜾	藖
𬜿	蔮
𬝁	䔡
𬝃	𤎤
𬝊	𦸷
𬝋	蠞
𬝖	𦵕
𬝠	𦽒
𬝯	薲
𬝴	䕼
𬞋	𦾶
𬞕	蘭
𬞘	藬
𬞟	蘋
𬞣	𧂅
𬞫	蘫
𬟁	虉
𬟪	覤
𬟺	𧐱
𬟽	蝀
𬠃	𧏻
𬠅	蟷
𬠈	𫋐
𬠐	𧈿
𬠠	蠈
𬠱	𧖦
𬠷	𧕦
𬡇	褭
𬡍	𧜣
𬡎	𧛸
𬡒	裌
𬡓	褺
𬡔	𧜂
𬡕	𧜁
𬡠	𧟌
𬡦	𧞶
𬡱	𫌙
𬡷	襸
𬡻	䊲
𬢇	𧠈
𬢈	𧡍
𬢉	𧠥
𬢊	覗
𬢋	覜
𬢌	覟
𬢍	𧠵
𬢎	覩
𬢏	𧡪
𬢐	䚉
𬢑	䚆
𬢒	覭
𬢓	𧢍
𬢔	覴
𬢕	𧣴
𬢪	譸
𬢯	譻
𬢳	謲
𬣀	讆
𬣍	𬣫
𬣘	𬤗
𬣙	訏
𬣚	𧥣
𬣛	䚳
𬣜	䚽
𬣝	𧥺
𬣞	詝
𬣟	䚵
𬣠	詌
𬣡	諓
𬣢	𧦭
𬣣	註
𬣤	詃
𬣥	詜
𬣦	詏
𬣧	䛍
𬣨	𧧝
𬣩	詴
𬣪	𧬨
𬣫	𬣍
𬣬	䛛
𬣭	譡
𬣮	詺
𬣯	䛘
𬣰	詯
𬣱	詶
𬣲	諩
𬣳	詪
𬣴	𧮇
𬣵	𧬻
𬣶	𧨊
𬣷	誎
𬣸	䛞
𬣹	䛤
𬣺	𧧭
𬣻	誔
𬣼	誏
𬣽	謰
𬣾	諎
𬣿	䜎
𬤀	諕
𬤁	䛬
𬤂	𧨾
𬤃	𰴽
𬤄	謲
𬤅	𧩦
𬤆	謴
𬤇	諲
𬤈	𧫚
𬤉	䜋
𬤊	諟
𬤋	𧩪
𬤌	䛽
𬤍	諻
𬤎	諠
𬤏	𧩧
𬤐	謌
𬤑	䛿
𬤒	𧪞
𬤓	𧪡
𬤔	𧪪
𬤕	𧪦
𬤖	𧬪
𬤗	𬣘
𬤘	䜉
𬤙	謼
𬤚	𧮆
𬤛	讇
𬤜	𧬅
𬤝	譓
𬤞	𧬇
𬤟	䜍
𬤠	𧬌
𬤡	䜒
𬤢	譐
𬤣	譈
𬤤	譄
𬤥	譔
𬤦	讉
𬤧	𧬮
𬤨	譟
𬤩	譺
𬤪	䜚
𬤫	譹
𬤬	䜝
𬤭	譿
𬤮	讚
𬤯	𧮈
𬤰	讙
𬤱	𧮓
𬤷	𧰆
𬥄	䝕
𬥈	䫉
𬥲	𬦀
𬥳	賶
𬥴	𧵊
𬥵	䝯
𬥶	貱
𬥷	𧶄
𬥸	賗
𬥹	𧶟
𬥺	䞁
𬥻	䞂
𬥼	𧶲
𬥽	䞀
𬥾	𧸦
𬥿	𧸪
𬦀	𬥲
𬦅	䞶
𬦆	𧽢
𬦣	𨇗
𬦥	䟺
𬦧	踚
𬦩	𨃘
𬦫	𨆅
𬦯	𨁂
𬦴	𨆱
𬦵	𨄰
𬦹	𨃜
𬦻	躀
𬦾	𨈇
𬧀	蹡
𬧃	䠮
𬧑	𨇍
𬧔	𬧙
𬧙	𬧔
𬧚	𨈀
𬧛	𨈆
𬧢	䡁
𬧤	軂
𬧩	𨉹
𬨁	軞
𬨂	軝
𬨃	𨋁
𬨄	軮
𬨅	𨋚
𬨆	䡗
𬨇	輆
𬨈	輓
𬨉	䡘
𬨋	𨌄
𬨌	䡟
𬨍	輵
𬨎	輶
𬨏	𨍐
𬨐	𨍹
𬨑	䡦
𬨒	𨎩
𬨓	轈
𬨔	䡶
𬩎	𨘌
𬩽	鄩
𬩾	郲
𬪍	鄮
𬪧	醧
𬪨	醆
𬪩	醲
𬪫	𨣉
𬪯	𨤋
𬪺	𨤡
𬬇	𨰵
𬬧	釬
𬬨	釫
𬬩	釴
𬬪	釦
𬬫	鈚
𬬬	鍏
𬬭	錀
𬬮	鋹
𬬯	鈓
𬬰	鎗
𬬱	釿
𬬲	釽
𬬳	𨥦
𬬴	𨥜
𬬵	鈂
𬬶	𨬞
𬬷	鉐
𬬸	鉥
𬬹	鉮
𬬺	鉏
𬬻	鑪
𬬼	𨭥
𬬽	鈼
𬬾	鑏
𬬿	鉊
𬭀	鈶
𬭁	鉧
𬭂	𨥺
𬭃	銔
𬭅	銗
𬭆	䤪
𬭇	𨭗
𬭈	䤩
𬭉	鑇
𬭊	𨧀
𬭋	𫒞
𬭌	鋘
𬭍	銲
𬭎	鋐
𬭏	鐊
𬭐	𨧚
𬭑	𨧫
𬭓	錪
𬭔	鑡
𬭕	錭
𬭖	錋
𬭗	錗
𬭘	𨨝
𬭙	𨭐
𬭚	錞
𬭛	𨨏
𬭜	錑
𬭝	鏒
𬭞	𨨹
𬭟	𨨯
𬭠	𨩨
𬭡	鍣
𬭢	鐀
𬭣	䤼
𬭤	鍭
𬭥	鍯
𬭦	鎒
𬭨	鎚
𬭩	鎓
𬭪	鎋
𬭫	𨫀
𬭬	鏏
𬭭	鏚
𬭯	䥕
𬭰	鏔
𬭱	𨬂
𬭲	鏁
𬭳	𨭎
𬭴	䥛
𬭵	𨭌
𬭶	𨭆
𬭷	𨭃
𬭸	鏻
𬭹	𨮅
𬭺	𨭚
𬭻	䥞
𬭼	鐩
𬭽	鐴
𬭾	𨮰
𬭿	鑙
𬮀	𨯵
𬮁	鑮
𬮂	𨰷
𬮃	𨰭
𬮄	𨲭
𬮇	𬮝
𬮍	𮤷
𬮘	閄
𬮙	𨷈
𬮜	𨳨
𬮝	𬮇
𬮟	焛
𬮠	閜
𬮡	𨳿
𬮢	閧
𬮣	𨴑
𬮤	閤
𬮥	閦
𬮧	𨴤
𬮨	䦝
𬮩	𨵆
𬮪	閯
𬮬	𮤒
𬮭	闚
𬮮	𨵤
𬮯	𨵗
𬮰	𨵌
𬮱	闉
𬮲	闄
𬮳	闆
𬮴	闇
𬮵	𨵬
𬮸	𨶻
𬮹	𨶿
𬮺	䧞
𬮻	隖
𬮿	隑
𬯀	隮
𬯅	陿
𬯊	𬯘
𬯎	隤
𬯘	𬯊
𬰡	𩉙
𬰣	𩉍
𬰤	𩋰
𬰥	䩫
𬰱	𩎒
𬰲	𩘚
𬰳	䪓
𬰴	𩎠
𬰵	𩏌
𬰶	韢
𬰷	䪜
𬰸	𩏴
𬰺	𩑃
𬱂	𬱚
𬱈	𬱩
𬱓	頄
𬱔	𩑣
𬱕	𩑦
𬱖	頔
𬱗	頕
𬱘	𫖞
𬱙	頖
𬱚	𬱂
𬱛	𩔊
𬱜	頛
𬱝	𩒝
𬱞	𠽸
𬱟	頠
𬱠	頢
𬱡	𩒜
𬱢	顐
𬱣	䫈
𬱤	𩒲
𬱥	𩒼
𬱦	䫏
𬱧	𩓸
𬱨	𩓹
𬱩	𬱈
𬱪	顊
𬱫	顁
𬱬	䫩
𬱭	𩔈
𬱮	䫜
𬱯	䭭
𬱰	䫠
𬱱	𩕊
𬱲	𩕰
𬱳	龥
𬱵	颹
𬱷	䫼
𬱸	䬂
𬱺	𩖿
𬱼	颽
𬱽	颴
𬱾	𮨭
𬱿	䬎
𬲀	䬍
𬲅	飉
𬲆	𩘻
𬲕	䭕
𬲚	𬳎
𬲛	𫗲
𬲥	𩚅
𬲦	飤
𬲧	𱃢
𬲨	𱃡
𬲩	𩚚
𬲪	𩞆
𬲫	䬯
𬲬	𩞡
𬲭	飷
𬲮	䬫
𬲯	䬲
𬲰	𩞃
𬲱	𮨻
𬲲	䭢
𬲳	䭞
𬲴	𩛎
𬲵	𫗑
𬲶	䭣
𬲷	䬶
𬲸	𩟂
𬲹	𩛲
𬲺	𩛞
𬲻	䬾
𬲼	餣
𬲽	𱃪
𬲾	䭅
𬲿	𩜠
𬳀	䭇
𬳁	餚
𬳂	餟
𬳃	𩜰
𬳄	𫗕
𬳅	䭉
𬳆	餰
𬳇	𩝑
𬳈	𩝡
𬳉	𩝣
𬳊	饀
𬳋	䭒
𬳌	𩝠
𬳍	餹
𬳎	𬲚
𬳐	𩞉
𬳑	䭘
𬳒	𩞬
𬳓	𩟀
𬳔	𩟠
𬳙	𫗻
𬳟	馩
𬳳	颿
𬳴	駍
𬳵	駓
𬳶	駉
𬳷	𩢍
𬳸	䮸
𬳹	𩣔
𬳺	𩢲
𬳻	𩢼
𬳼	𩣋
𬳽	駪
𬳾	䮈
𬳿	駼
𬴀	駺
𬴁	䮗
𬴂	騑
𬴃	騞
𬴄	𩤵
𬴅	騯
𬴆	騹
𬴇	𩥲
𬴈	𩥼
𬴉	𩦚
𬴊	驎
𬴋	驖
𬴌	𩦺
𬴍	䮽
𬴎	𩧐
𬴏	䮿
𬴐	驩
𬴨	𩯆
𬴩	鬞
𬵂	𱇎
𬵃	𬶃
𬵮	𬶑
𬶀	魝
𬶁	魜
𬶂	𩵚
𬶃	𬵃
𬶄	魡
𬶅	𩶀
𬶆	䰷
𬶇	魪
𬶈	𩵺
𬶉	𩵱
𬶊	䱍
𬶋	鮈
𬶌	鮘
𬶍	鮀
𬶎	䲙
𬶏	鮠
𬶐	鮡
𬶑	𬵮
𬶒	𩷒
𬶓	䱓
𬶔	鯌
𬶕	鮷
𬶖	𩸆
𬶗	䲏
𬶙	𩸣
𬶚	𩸤
𬶛	鱓
𬶜	𩸬
𬶝	𩸩
𬶞	鰗
𬶟	鯻
𬶠	鰊
𬶡	𩹝
𬶢	鯹
𬶣	䱹
𬶤	䱱
𬶥	𱇋
𬶦	𩹊
𬶧	鰇
𬶨	鱀
𬶩	𩹽
𬶪	𩺝
𬶫	鱑
𬶬	鱋
𬶭	鰶
𬶮	鱚
𬶯	𩻧
𬶰	𩻰
𬶱	𩻱
𬶲	鱌
𬶳	𩽈
𬶴	䲕
𬶵	鱞
𬶶	𩼔
𬶷	𣤿
𬶸	𩽅
𬶹	𩽔
𬶺	鱹
𬶻	𩽷
𬶼	𱉉
𬷕	鵏
𬷻	𩾐
𬷼	鶂
𬷽	𩾒
𬷾	䲨
𬷿	𪅜
𬸀	鴍
𬸁	𩿺
𬸂	𪀉
𬸃	𩿱
𬸄	𪈗
𬸅	鶵
𬸆	䲼
𬸈	鵄
𬸉	𪀛
𬸊	鵀
𬸋	𪀻
𬸌	𪄅
𬸍	𪇘
𬸎	𪁐
𬸏	𪁜
𬸐	𪁱
𬸑	𪁑
𬸒	鶀
𬸓	𪂫
𬸔	𪁿
𬸕	鸎
𬸖	𪂈
𬸗	𪂩
𬸘	鶠
𬸙	𪃦
𬸚	鸑
𬸛	䳨
𬸜	鶣
𬸝	鶕
𬸞	鷜
𬸟	𪃮
𬸠	𪃿
𬸡	𪇖
𬸢	鷎
𬸣	鶱
𬸤	𪅃
𬸥	𪅖
𬸦	鷟
𬸧	鷰
𬸨	𪅾
𬸩	䴈
𬸪	鷭
𬸫	𪆃
𬸬	𪇄
𬸭	𪆰
𬸮	𪆴
𬸯	鷿
𬸰	鸖
𬸱	鸜
𬸵	𪉜
𬸶	𪉨
𬸷	𪉮
𬸸	𪉱
𬸹	𪉿
𬸾	麡
𬹂	𬹆
𬹅	䴭
𬹆	𬹂
𬹇	𪌰
𬹈	𪌯
𬹉	䴷
𬹊	𪍀
𬹋	𪌽
𬹌	𪌿
𬹍	𪍤
𬹎	𪍶
𬹕	𪑳
𬹖	𪒬
𬹗	𪑚
𬹘	𪒿
𬹣	鼄
𬹤	𪓽
𬹭	𪕣
𬹺	齖
𬹻	𪗝
𬹼	齘
𬹽	𪗜
𬹾	𪗳
𬹿	𪗪
𬺀	𪗭
𬺁	𪗻
𬺂	𩖁
𬺃	䶣
𬺄	𪗽
𬺅	𪙞
𬺆	𪘞
𬺇	𪘓
𬺈	齮
𬺉	䶦
𬺊	𪘩
𬺋	𪘧
𬺌	𪘲
𬺍	䶢
𬺎	齹
𬺏	𪙍
𬺐	𪙕
𬺑	𪙑
𬺒	𪙤
𬺓	齼
𬺔	齽
𬺕	䶪
𬺖	𪚅
𬺛	𪚔
𬺜	㰍
𬺝	𪚣
𬺟	𧢢
𬻮	𫯓
𬾖	㒣
𬾣	𠐮
𭀖	𭀖 釐 厘
𭂖	𰃶
𭄛	劗
𭇀	𠿿
𭇉	𫪛
𭇙	𡁚
𭇜	㗶
𭇡	𡁯
𭇯	嚠
𭇴	𠵔
𭈈	𠺖
𭈉	𡄖
𭈜	𡀠
𭈟	𠽈
𭈮	𡄤
𭉗	𪢍
𭉨	𠿘
𭉼	𡅧
𭉾	𰇊
𭊸	𡅘
𭎂	㙡
𭎜	壔
𭏦	壒
𭏸	壝
𭑙	𮤮
𭑸	𡢿
𭑹	𡤡
𭓀	𫲴
𭕆	𧴪
𭗡	𡻘
𭘓	幠
𭘚	𢅣
𭚦	彍
𭝋	㦭
𭝫	𡄩
𭞄	懓
𭠙	擈
𭠽	𰔠
𭡆	𪯂
𭡜	𢸙
𭡵	𢵣
𭢋	𢸔
𭢒	𰓤
𭢕	𢷞
𭢝	𢺎
𭣇	攧
𭣧	斁
𭤎	斄
𭤰	旟
𭥓	𣊯
𭧋	曭
𭧒	𰖏
𭧖	𰖚
𭨡	𰁈
𭩚	檥
𭩛	椚
𭩰	橃
𭪆	檛
𭫀	樻
𭫙	㰅
𭫝	𠐇
𭭈	㰳
𭰎	澢
𭰒	𣻑
𭰗	𣼊
𭰥	𤅩
𭱀	𪷈
𭱊	澒
𭱘	𰛨
𭲫	灟
𭴊	㷻
𭴳	𤏐
𭶙	𤇻
𭹜	㼈
𭻍	𤲢
𭻔	𤲓
𮀡	𥘃
𮀤	磱
𮀪	𥖏
𮀲	𥔂
𮅎	𥵛
𮆏	籣
𮇔	𥺼
𮇤	𥾂
𮉠	䊵
𮉡	纑
𮉢	紩
𮉣	䋏
𮉤	絓
𮉥	𦀎
𮉧	緉
𮉨	緺
𮉩	𫃥
𮉪	緅
𮉫	緌
𮉬	綷
𮉭	𫃷
𮉮	繀
𮉯	縩
𮌌	𦡧
𮎍	𫇠
𮏀	𫉍
𮏺	𧁿
𮐚	薠
𮐨	蘡
𮔂	䗻
𮔅	蝜
𮔊	蜽
𮖁	裲
𮖃	𧜶
𮖱	襭
𮙊	讔
𮙋	讟
𮛗	𨆉
𮜗	𰸦
𮜶	軇
𮝴	軱
𮝵	輀
𮝷	轒
𮝸	輴
𮝹	轘
𮝺	轕
𮟽	𰻨
𮠞	䤌
𮠳	醦
𮡈	𨢸
𮣲	釭
𮣳	鈜
𮣴	鋋
𮣵	錣
𮣶	鑢
𮤏	𮤳
𮤒	𬮬
𮤫	閅
𮤬	䦌
𮤭	𨳒
𮤮	𭑙
𮤯	𨳙
𮤲	閟
𮤳	𮤏
𮤶	𰿢
𮤷	𬮍
𮤸	𨶯
𮦅	𮦗
𮦗	𮦅
𮦚	𩇉
𮧴	韔
𮧵	韡
𮨭	𬱾
𮨴	檒
𮨵	飂
𮨻	𬲱
𮩛	饆
𮩜	餀
𮩝	餲
𮩞	饐
𮪡	駹
𮪢	駴
𮪣	騣
𮪤	騲
𮪥	驐
𮫂	鬡
𮬛	魣
𮬜	鮨
𮬝	鱥
𮬞	䱗
𮬟	䱛
𮬠	䱚
𮬡	䱻
𮬢	䱵
𮬣	䲗
𮬤	鱵
𮭡	䲸
𮭢	鴁
𮭤	鴓
𮭥	䳍
𮭦	𪁏
𮭨	鷃
𮭪	鷞
𮭰	䴚
𮮅	𪌒
𮮇	麰
𮯙	䶗
冗	冗
灰	灰
冒	冒
𰁈	𭨡
𰁧	傱
𰁸	儅
𰁾	偩
𰂁	𪝵
𰂃	𠎅
𰂋	僴
𰂎	僩
𰂏	儥
𰂗	僀
𰂜	僓
𰂠	𪜺
𰂦	儢
𰂭	儩
𰂴	𫢜
𰂻	𠑇
𰃆	儹
𰃳	𰃴
𰃴	𰃳
𰃶	𭂖
𰃷	凔
𰃻	㓖
𰃿	凟
𰄁	𠗿
𰄞	剸
𰄭	𠠫
𰅔	勴
𰅥	匵
𰅦	匰
𰅻	𦾏
𰆕	㕒
𰆙	𠩬
𰆚	厱
𰇀	㕢
𰇊	𭉾
𰇎	㖦
𰇕	唊
𰇖	㗢
𰇘	𠷌
𰇠	嗧
𰇡	𠶹
𰇣	嚱
𰇥	𫬱
𰇲	嗿
𰇼	嘇
𰈆	囕
𰈇	嚐
𰈊	嚸
𰈍	嚫
𰈓	嚂
𰈝	𫪑
𰈮	𡃈
𰈯	囐
𰈶	嚩
𰉀	𪢋
𰉁	㘖
𰉄	囋
𰉘	㙔
𰉙	堈
𰉚	垷
𰉣	墿
𰉥	埉
𰉩	墧
𰉪	墷
𰉱	𡑯
𰉽	㙾
𰊂	墆
𰊅	𡓦
𰊈	墏
𰊑	壏
𰊛	㙺
𰊟	㙢
𰊡	壛
𰊢	壍
𰋆	𪤅
𰋖	𡗆
𰋸	婸
𰋹	嫥
𰋽	嬮
𰋾	𡠚
𰌀	嫈
𰌂	媜
𰌆	㜞
𰌇	嫧
𰌉	𡢘
𰌙	嬾
𰌦	孲
𰌷	寪
𰎌	嵷
𰎎	巃
𰎏	崠
𰎐	㠠
𰎑	嶪
𰎔	嶤
𰎖	崱
𰎛	𡼾
𰎝	𡺠
𰎞	嶩
𰎠	巖
𰎢	𡼱
𰎦	𰎼
𰎫	嶽
𰎴	𪌨
𰎷	𡾆
𰎹	巚
𰎼	𰎦
𰏁	巑
𰏓	𢄓
𰏕	帴
𰏜	㡞
𰏟	幱
𰏲	𢉿
𰏶	廥
𰏼	廗
𰏽	𢊃
𰐚	𢐗
𰐾	懭
𰑁	慱
𰑄	惀
𰑅	𢠰
𰑔	慹
𰑕	懕
𰑙	懰
𰑟	慐
𰑥	憪
𰑧	慙
𰑪	憴
𰑫	㦬
𰑬	懫
𰑵	慸
𰑸	㥷
𰑿	戃
𰒆	慲
𰒒	懘
𰒖	𢤧
𰓄	掁
𰓆	摀
𰓔	㨛
𰓕	𢸸
𰓗	𢹥
𰓙	擪
𰓜	擳
𰓝	𢲐
𰓟	𢹼
𰓤	𭢒
𰓧	搎
𰓬	攦
𰓱	摼
𰓷	撋
𰓻	摫
𰓼	摲
𰔇	摕
𰔋	撌
𰔠	𭠽
𰔫	𫽫
𰔲	㩷
𰔶	𢹏
𰔺	𫽢
𰕁	攳
𰕅	敺
𰕈	敿
𰕐	𢿡
𰕭	旝
𰖈	曮
𰖏	𭧒
𰖚	𭧖
𰖠	㬮
𰖩	㒿
𰖻	𬁘
𰗅	𦡏
𰗆	𦡖
𰗓	櫎
𰗖	棆
𰗘	𣔿
𰗙	㮲
𰗚	𣞐
𰗛	檡
𰗜	檿
𰗡	㯆
𰗢	楎
𰗦	㯸
𰗨	榯
𰗬	櫏
𰗵	㰂
𰗹	橚
𰗺	橨
𰘀	㯂
𰘅	𰘯
𰘈	檋
𰘓	檾
𰘠	櫩
𰘣	檰
𰘩	櫹
𰘯	𰘅
𰘳	櫴
𰘶	櫯
𰘸	櫢
𰙋	歍
𰙎	歛
𰙑	歗
𰙕	𣤋
𰚂	𪵇
𰚍	𰚣
𰚔	㲰
𰚣	𰚍
𰚦	氀
𰚪	㲯
𰚬	𪵢
𰚱	𣰛
𰛉	𣶯
𰛊	溤
𰛏	漎
𰛒	涷
𰛛	㴸
𰛡	滭
𰛣	漐
𰛤	瀄
𰛥	溰
𰛦	濊
𰛨	𭱘
𰛩	㶒
𰛪	灓
𰛮	滷
𰛱	𰝢
𰛲	澰
𰛵	澖
𰛺	𣼩
𰛻	𤅷
𰛽	㴿
𰜐	灠
𰜜	瀙
𰜝	瀁
𰜢	㵑
𰜨	瀳
𰜳	瀴
𰝅	瀯
𰝋	㶏
𰝍	瀈
𰝗	㶕
𰝜	𣴇
𰝞	𤄙
𰝟	㶍
𰝢	𰛱
𰝤	灦
𰝾	㷃
𰞇	燡
𰞉	㷲
𰞍	㸅
𰞤	熞
𰞲	㷶
𰞳	龽
𰞷	𤍜
𰞻	燌
𰟄	𰟫
𰟘	爓
𰟫	𰟄
𰠛	牋
𰠫	犅
𰠲	牼
𰠴	㹓
𰠹	犤
𰡄	獹
𰡉	𰡓
𰡊	獢
𰡋	𤟤
𰡎	猍
𰡏	猧
𰡐	𤠔
𰡓	𰡉
𰡔	獑
𰡞	獖
𰡢	𤣎
𰡩	玂
𰡰	𤥭
𰡵	瓐
𰡻	瑙
𰡽	璹
𰢄	璛
𰢢	甒
𰢤	甖
𰢦	甊
𰣢	𬏲
𰣦	𤺉
𰣩	𤻝
𰣫	𤼈
𰣬	癠
𰣯	癎
𰣶	㿉
𰣼	癪
𰣽	癴
𰤓	𤾉
𰤕	皪
𰤨	㿹
𰤫	𥀲
𰤬	皾
𰤽	𥂫
𰥊	䀍
𰥒	瞛
𰥛	瞓
𰥞	䁝
𰥠	矕
𰥢	矖
𰥣	𥉸
𰥨	瞯
𰥪	瞡
𰥭	𥋝
𰥹	矘
𰦔	䂓
𰦜	矲
𰦦	礰
𰦨	䃣
𰦭	礲
𰦰	礋
𰦴	䃁
𰦷	䃕
𰦾	礹
𰦿	碢
𰧃	磵
𰧇	礥
𰧈	𥗹
𰧉	礩
𰧎	䃢
𰧔	礛
𰧘	䃴
𰧰	禓
𰧻	禬
𰧾	禯
𰨖	禵
𰨜	穬
𰨦	穧
𰨳	䆅
𰩅	竉
𰩏	窱
𰩓	竀
𰩧	䇓
𰩮	篿
𰩲	籚
𰩸	簥
𰩹	簜
𰩺	箹
𰩻	簻
𰪊	籦
𰪏	簵
𰪣	籯
𰪪	𰫆
𰪫	䊜
𰪭	粻
𰪶	糰
𰪼	𰫏
𰪿	𫃑
𰫆	𰪪
𰫋	䊟
𰫏	𰪼
𰫖	糷
𰫛	𬘗
𰫳	𬙄
𰫼	糽
𰫽	紑
𰫿	𫃞
𰬀	紒
𰬁	䋆
𰬂	䋍
𰬃	䋑
𰬅	紨
𰬆	絇
𰬇	紸
𰬈	絃
𰬉	紽
𰬋	紭
𰬌	絚
𰬍	綊
𰬎	縪
𰬏	絑
𰬐	繑
𰬑	䋫
𰬒	絘
𰬓	絯
𰬔	絣
𰬖	絾
𰬗	絿
𰬘	綍
𰬙	𦁄
𰬚	縜
𰬛	絼
𰬜	絻
𰬝	𦅘
𰬞	綅
𰬟	緎
𰬠	繣
𰬡	緁
𰬢	緀
𰬣	緆
𰬤	綼
𰬥	総
𰬦	𦁕
𰬧	緂
𰬨	𦁧
𰬩	繡
𰬪	縿
𰬫	緻
𰬬	緢
𰬭	䋽
𰬮	縴
𰬯	緵
𰬰	緫
𰬱	䌇
𰬲	縓
𰬳	縌
𰬴	縡
𰬵	縼
𰬶	䌌
𰬷	繖
𰬸	繐
𰬹	𦆈
𰬺	繜
𰬻	繘
𰬼	𦇛
𰬽	繲
𰬾	𦆆
𰬿	纀
𰭀	纋
𰭁	𦇎
𰭄	罆
𰭔	羂
𰭗	𦏑
𰭚	𦎹
𰭢	翜
𰭣	翿
𰭹	䏊
𰮅	膷
𰮇	膴
𰮙	䐢
𰮝	膮
𰮭	𣎜
𰮲	䐹
𰯂	𦡶
𰯋	臡
𰯎	䐽
𰰆	𦧴
𰰋	艭
𰰌	䑼
𰰏	艜
𰰑	艛
𰰠	藇
𰰢	𦳝
𰰤	蓲
𰰨	菕
𰰮	蘬
𰰱	薱
𰰳	蒒
𰰴	䔇
𰰵	蔱
𰰶	䕹
𰰷	萯
𰰹	藰
𰰺	蔎
𰰾	薖
𰰿	𫈹
𰱀	䔈
𰱇	蕑
𰱈	禜
𰱉	蕄
𰱊	𧃽
𰱌	蒳
𰱍	蒶
𰱐	藚
𰱑	蔪
𰱛	蔠
𰱝	𦺣
𰱟	蕡
𰱦	蕧
𰱩	䕡
𰱮	藘
𰱯	藣
𰱱	薋
𰱲	蘵
𰱾	藾
𰲁	蘈
𰲂	虅
𰲒	蘱
𰲖	䖀
𰲟	䖚
𰲠	虦
𰲫	蟱
𰲬	蛼
𰲮	蜸
𰲯	䗥
𰲰	蜦
𰲲	蟡
𰲳	䗃
𰲴	蠪
𰲵	蠌
𰲶	蛵
𰲸	蝁
𰲹	螘
𰲺	𧒖
𰲻	蟽
𰳁	𧐐
𰳂	螹
𰳄	螴
𰳆	𪘅
𰳊	蟦
𰳗	蠳
𰳚	䗽
𰳲	襱
𰳵	襼
𰳸	襨
𰳹	𧞣
𰳺	襛
𰳻	𧞅
𰳼	襹
𰴂	襂
𰴏	𫌩
𰴕	覕
𰴖	䙼
𰴗	䚕
𰴘	覸
𰴙	覠
𰴚	𧢃
𰴛	𧡸
𰴜	覰
𰴝	覶
𰴞	覻
𰴢	觻
𰴣	觷
𰴤	䚞
𰴥	𰴦
𰴦	𰴥
𰴯	謍
𰴽	𬤃
𰵊	訆
𰵌	諹
𰵍	訰
𰵎	訧
𰵏	訬
𰵐	䛀
𰵑	譌
𰵒	訦
𰵓	訹
𰵔	詍
𰵖	讛
𰵗	詇
𰵘	𧦦
𰵙	詄
𰵚	詅
𰵛	訽
𰵜	䛌
𰵝	訸
𰵞	詠
𰵠	詉
𰵡	誙
𰵢	𧧵
𰵣	詥
𰵤	詻
𰵥	誃
𰵦	詨
𰵧	誌
𰵨	讝
𰵩	誧
𰵪	𧨝
𰵫	䛠
𰵬	𧧸
𰵭	誗
𰵮	誐
𰵯	誜
𰵰	䛭
𰵱	諃
𰵲	諆
𰵳	𧨳
𰵴	諔
𰵵	誽
𰵶	諈
𰵷	諁
𰵸	誻
𰵹	讘
𰵺	謜
𰵻	𧪮
𰵼	謋
𰵽	謟
𰵾	謑
𰵿	謞
𰶀	謣
𰶁	謻
𰶂	謥
𰶃	謵
𰶄	譇
𰶅	𧬁
𰶆	譀
𰶇	䜏
𰶈	䜄
𰶉	譠
𰶊	譩
𰶋	𧬯
𰶌	譳
𰶍	讂
𰶎	譅
𰶏	讑
𰶑	豅
𰶔	豄
𰶨	𧱻
𰶬	䝏
𰷞	貣
𰷠	貤
𰷡	貦
𰷢	貾
𰷤	賥
𰷥	賨
𰷦	靅
𰷧	賮
𰷨	𧷛
𰷩	䞉
𰷪	賹
𰷫	贆
𰷬	𧸖
𰷭	贓
𰷮	贙
𰷴	䟏
𰷵	趬
𰷶	趫
𰷸	𧾥
𰸇	𨇯
𰸈	䠟
𰸊	䠩
𰸎	𨄉
𰸐	躧
𰸔	蹥
𰸚	蹛
𰸛	䠠
𰸞	蹪
𰸦	𮜗
𰹀	軃
𰹈	𰹯
𰹯	𰹈
𰹱	𨊠
𰹲	軎
𰹳	䡅
𰹴	軓
𰹵	轙
𰹶	軖
𰹷	䡇
𰹸	軘
𰹺	䡊
𰹻	𨊹
𰹼	輚
𰹽	軯
𰹾	𨍒
𰹿	軵
𰺀	軧
𰺁	軥
𰺂	軳
𰺃	轛
𰺄	輁
𰺅	輂
𰺆	𨋮
𰺇	輐
𰺈	輑
𰺉	輤
𰺊	輘
𰺋	輙
𰺌	𨏔
𰺍	輠
𰺎	輫
𰺏	輣
𰺐	輡
𰺑	䡝
𰺒	輲
𰺓	輹
𰺔	𨍈
𰺕	𨍏
𰺖	轃
𰺗	轞
𰺘	䡰
𰺙	轖
𰺚	𨎪
𰺛	轑
𰺜	轓
𰺝	䡴
𰺞	轏
𰺟	轚
𰺠	䡾
𰺡	䡷
𰺢	𨏒
𰺣	轥
𰺤	䡻
𰺨	𨐶
𰺭	䢈
𰺲	逿
𰺷	遶
𰻆	遰
𰻝	𰻞
𰻞	𰻝
𰻡	鄦
𰻦	鄬
𰻨	𮟽
𰻮	鄡
𰻳	鄪
𰼅	醳
𰼋	𨣃
𰼏	𨣨
𰼑	䤍
𰼻	鑋
𰽕	鐖
𰽖	釛
𰽗	釪
𰽘	釱
𰽚	鑛
𰽛	釥
𰽜	鏂
𰽝	䥶
𰽞	鈪
𰽠	䤠
𰽡	鈤
𰽢	鋧
𰽣	鈏
𰽥	鈵
𰽦	鑨
𰽧	鉟
𰽨	鉙
𰽩	鉲
𰽫	鉎
𰽬	鉌
𰽭	鉤
𰽮	鉜
𰽯	鉒
𰽰	鉡
𰽱	鉘
𰽲	銡
𰽳	顉
𰽴	銙
𰽵	銧
𰽶	鉵
𰽷	鐬
𰽸	䤨
𰽹	鉹
𰽺	䤥
𰽻	銋
𰽼	鉼
𰽽	𨦡
𰽾	鐹
𰽿	銸
𰾀	鋍
𰾁	銾
𰾃	鋜
𰾄	鋂
𰾅	鋡
𰾆	鋊
𰾇	𨧐
𰾈	䤬
𰾉	𫒢
𰾋	龲
𰾌	鏩
𰾍	錶
𰾎	錍
𰾏	鋾
𰾐	䤵
𰾑	鍂
𰾒	錧
𰾓	錔
𰾕	鍱
𰾖	䤻
𰾗	鍼
𰾘	鍖
𰾙	鍝
𰾚	鍡
𰾛	鎅
𰾜	鍴
𰾝	鍟
𰾞	鍐
𰾟	鍑
𰾡	鍧
𰾢	鍦
𰾣	𫒷
𰾤	鍜
𰾥	鍨
𰾦	䤸
𰾧	𨫼
𰾨	𨪋
𰾩	鎑
𰾪	鐚
𰾫	鑑
𰾬	鎉
𰾭	鑀
𰾮	鎌
𰾯	鎕
𰾰	鏙
𰾱	鏓
𰾲	鏕
𰾳	𨬒
𰾴	鐁
𰾵	𨬟
𰾶	鏸
𰾷	鐕
𰾸	鐤
𰾹	鐫
𰾺	𨮁
𰾻	䥖
𰾼	鐉
𰾽	钃
𰾾	钀
𰾿	𨭛
𰿀	𨰹
𰿁	䥝
𰿂	鑐
𰿃	鑖
𰿄	鑘
𰿅	䥴
𰿆	鑽
𰿇	䥷
𰿈	鑯
𰿉	鑸
𰿊	𨰠
𰿖	𨱥
𰿢	𮤶
𰿥	𫔘
𰿦	𨳌
𰿧	𨳐
𰿨	䦎
𰿩	閕
𰿪	𨳚
𰿫	䦱
𰿬	閛
𰿭	𨳸
𰿯	𫔡
𰿰	𨉖
𰿳	閷
𰿴	䦪
𰿵	𨵦
𰿸	𨶑
𰿹	𨶰
𰿺	闛
𰿻	闟
𰿾	闢
𱀑	隲
𱀡	隫
𱁒	䨴
𱁞	𩅦
𱁱	𩋌
𱁳	𩍜
𱁴	鞸
𱁶	韆
𱁷	韇
𱁹	鞼
𱁺	鞻
𱁽	䪍
𱁾	韊
𱂃	𩎕
𱂄	𩎟
𱂅	䪐
𱂆	韐
𱂇	韏
𱂈	韗
𱂉	韒
𱂊	韘
𱂋	韣
𱂌	䪝
𱂍	𩐌
𱂎	䪥
𱂐	韻
𱂠	𩑒
𱂡	𩑡
𱂢	䪼
𱂣	顤
𱂤	顪
𱂥	頟
𱂦	頩
𱂧	頪
𱂨	頞
𱂩	𩒺
𱂫	顩
𱂬	頯
𱂭	顀
𱂮	䫌
𱂯	顇
𱂰	顄
𱂱	顑
𱂲	顋
𱂳	𩔇
𱂴	顜
𱂵	顝
𱂶	顖
𱂷	𩔣
𱂸	顮
𱂺	顠
𱂻	顦
𱃔	颩
𱃕	颬
𱃖	䬀
𱃗	颱
𱃘	颲
𱃙	䬟
𱃚	䬅
𱃛	𩗛
𱃜	䬐
𱃝	飍
𱃞	䬔
𱃟	飁
𱃠	飇
𱃡	𬲨
𱃢	𬲧
𱃪	𬲽
𱃱	䬣
𱃲	饇
𱃳	䬪
𱃴	飰
𱃵	䬬
𱃷	䬳
𱃸	䬹
𱃹	䭓
𱃺	餂
𱃼	餴
𱃽	餩
𱃾	餢
𱃿	餤
𱄀	饙
𱄁	𩜶
𱄂	𩜯
𱄃	䭈
𱄄	餯
𱄅	𩝧
𱄆	饎
𱄇	𩞧
𱄈	饛
𱄉	䭡
𱄊	饡
𱄼	馵
𱄽	馲
𱄾	𩧉
𱄿	騳
𱅀	駂
𱅁	馽
𱅂	馺
𱅃	駏
𱅄	䮂
𱅅	驡
𱅇	駗
𱅈	駜
𱅉	駥
𱅊	騺
𱅋	駬
𱅍	𩣊
𱅎	𩢰
𱅏	駣
𱅐	駮
𱅒	𩧢
𱅓	𩣡
𱅔	駷
𱅕	騋
𱅖	駽
𱅗	騀
𱅘	𩦃
𱅙	駾
𱅚	騇
𱅛	驒
𱅜	騕
𱅝	騗
𱅞	騢
𱅟	騥
𱅠	䮧
𱅡	騩
𱅢	騬
𱅣	𩥅
𱅤	驞
𱅥	𩥃
𱅦	䮲
𱅧	驉
𱅨	𩥎
𱅩	騽
𱅪	驔
𱅫	驈
𱅬	驠
𱅮	髐
𱆀	鬝
𱆁	鬜
𱆃	䰎
𱆄	𩯃
𱆅	䰐
𱆆	鬗
𱆈	䰖
𱆌	鬺
𱆍	𩱈
𱆖	𩴆
𱆙	䰫
𱆚	䫥
𱆛	魗
𱆥	鿕
𱇋	𬶥
𱇍	䰲
𱇎	𬵂
𱇏	魠
𱇐	魭
𱇑	䰽
𱇒	魮
𱇓	魱
𱇔	魶
𱇕	䰻
𱇖	魬
𱇗	鯩
𱇘	魧
𱇙	魫
𱇚	䱅
𱇛	鮇
𱇜	魼
𱇝	魾
𱇞	䱇
𱇟	魻
𱇠	鮂
𱇡	鮏
𱇢	鮌
𱇣	鱍
𱇤	䱂
𱇥	䱎
𱇦	鮬
𱇧	鮧
𱇨	鮛
𱇩	鱎
𱇪	鮥
𱇫	𩶯
𱇬	䱌
𱇭	鯠
𱇮	𩷶
𱇯	鮹
𱇰	䱒
𱇱	鯈
𱇲	䱐
𱇳	鮻
𱇴	𩹾
𱇵	鰿
𱇶	鯥
𱇷	䱜
𱇸	鱦
𱇹	䱥
𱇺	鯚
𱇻	䱤
𱇼	鯦
𱇽	䱡
𱇾	鯮
𱇿	鱐
𱈀	䱟
𱈁	鯅
𱈂	鰅
𱈃	𩹂
𱈄	鯸
𱈅	鯼
𱈆	䱾
𱈇	䱭
𱈈	䱴
𱈉	鰬
𱈊	鰡
𱈋	鰝
𱈌	鱃
𱈍	鰯
𱈎	𩺞
𱈏	鱁
𱈐	鱄
𱈑	鰴
𱈒	䲉
𱈓	鱏
𱈔	𩻛
𱈕	鱕
𱈖	䲚
𱈗	鱬
𱈘	鱨
𱈙	鱴
𱈚	鱷
𱈛	䲛
𱈜	鱻
𱉇	鳦
𱉈	鳭
𱉉	𬶼
𱉊	鳱
𱉋	𩾝
𱉌	鸃
𱉍	鳿
𱉎	鳺
𱉏	鷒
𱉐	鵙
𱉑	鳻
𱉒	𩿊
𱉓	鳸
𱉔	鴂
𱉕	鴚
𱉖	䲹
𱉗	鴠
𱉘	鴡
𱉙	䳅
𱉚	鴩
𱉛	鴙
𱉜	𩿧
𱉝	鵖
𱉞	䳇
𱉟	鸅
𱉠	鵛
𱉡	鴘
𱉢	鴢
𱉣	𪀚
𱉤	䳏
𱉥	鴶
𱉦	䳓
𱉧	䳒
𱉨	鵶
𱉩	鴺
𱉪	鴱
𱉫	鴸
𱉬	鷮
𱉭	𪀗
𱉮	鵅
𱉯	鴹
𱉰	鸒
𱉱	鶤
𱉲	鴾
𱉳	鷶
𱉴	鸉
𱉵	鶆
𱉶	䳚
𱉷	𪁛
𱉸	鵌
𱉹	鵗
𱉺	䳕
𱉻	鵎
𱉼	䳭
𱉽	鵋
𱉾	鵕
𱉿	鵔
𱊀	鵱
𱊁	鵸
𱊂	䳟
𱊃	鵹
𱊄	鶃
𱊅	鵻
𱊆	鵵
𱊇	鵴
𱊈	鶂
𱊉	𪈔
𱊊	鵼
𱊋	鵳
𱊌	鶋
𱊍	鵽
𱊎	鶅
𱊏	鶝
𱊐	鶛
𱊑	鶞
𱊒	鶢
𱊓	䳮
𱊔	𪃃
𱊕	鶙
𱊖	鶟
𱊗	鶔
𱊘	鶨
𱊙	䳲
𱊚	鷏
𱊛	鶽
𱊜	𪈼
𱊝	鶶
𱊞	𪄠
𱊟	鶷
𱊠	鷋
𱊡	鷕
𱊢	鷑
𱊣	䳺
𱊤	鷛
𱊥	𪄲
𱊦	鷧
𱊧	鷢
𱊨	𪆫
𱊩	鷵
𱊪	䴇
𱊫	鸆
𱊬	鸀
𱊭	鸒
𱊮	鸁
𱊯	鸄
𱊰	鷾
𱊱	鸐
𱊲	𪇰
𱊳	鸓
𱊴	𪈏
𱊵	鸙
𱊺	𪉖
𱊻	𪉣
𱊼	䴝
𱊽	𪊉
𱋂	𪋈
𱋄	𪋽
𱋅	𪋼
𱋆	䴮
𱋇	麧
𱋈	𪍿
𱋉	𪌐
𱋊	䴲
𱋋	麮
𱋌	𪌗
𱋍	𪌘
𱋎	䴳
𱋐	麯
𱋑	𪍷
𱋓	𪌣
𱋔	䴵
𱋕	𪌬
𱋖	麱
𱋗	䴸
𱋘	𪌮
𱋙	䴹
𱋚	𪌾
𱋜	𪍇
𱋝	䴺
𱋟	𪍒
𱋠	𪍍
𱋡	𪍣
𱋢	𪍑
𱋣	𪍚
𱋤	𪍘
𱋥	𪍓
𱋦	𪍞
𱋨	𪍬
𱋪	䵂
𱋫	䵃
𱋬	𪍴
𱋭	𪎂
𱋮	䵆
𱋱	黂
𱋴	䵐
𱋶	黸
𱋾	鼀
𱋿	鼁
𱌀	𪓛
𱌁	䵶
𱌃	䵷
𱌄	鼅
𱌅	𪓬
𱌆	鼆
𱌇	鼈
𱌈	𪓹
𱌉	鼊
𱌊	鼚
𱌏	鼲
𱌕	𪖨
𱌖	齈
𱌗	齌
𱌘	齍
𱌙	𪗋
𱌫	齞
𱌬	齚
𱌭	齺
𱌮	齣
𱌯	齝
𱌰	䶧
𱌱	齥
𱌲	齤
𱌳	齳
𱌴	𪘨
𱌵	䶨
𱌶	齱
𱌷	𪘬
𱌸	𪘥
𱌹	齵
𱌺	齻
𱌼	𪙉
𱌽	齸
𱍁	龏
𱍂	龖
𱍄	𪚮
𱍅	𪚭
𱍆	𪚰
𱍇	䶱
𱍈	龞
𱍉	𪛕
