㐁	𠀬
㐌	𡧀
㐐	㐗
㐙	㐈
㐜	𠂃
㐨	㜿
㐫	𡿺
㐰	𠇅
㐷	傌
㐻	𫵓
㐽	偑
㑆	𫢢
㑈	倲
㑋	𩅯
㑕	𬿳
㑮	𫝈
㑯	㑔
㑾	𠌠
㒄	㦓
㒅	𧙾
㒚	𠋎
㒞	㒞
㒠	𠏪
㒨	𠑗
㒩	𢥾
㒹	㒹
㒻	㒻
㒼	𬜯
㒾	𦋤
㒿	𰖩
㓃	𨶃
㓎	𠖶
㓖	𰃻
㓟	㓟
㓡	𠛺
㓢	㪾
㓱	𠞼
㓴	𠟺
㓸	𠠇
㓾	𠞂
㔃	𫦌
㔅	𫦅
㔆	𠟆
㔋	𪟎
㔌	𠟕
㔓	𠚲
㔕	㔕
㔝	𫦩
㔡	𠢒
㔢	𫦳
㔤	𡫘
㔯	𠤰
㔴	𠥦
㔷	𠥮
㔹	𭃄
㔾	⺋
㕓	𫑮
㕙	𠬍
㕣	𧮲
㕨	𫩓
㕫	𪴩
㕰	𣬦
㕷	𪴭
㕸	𠴹
㕻	𪠹
㖃	𫩲
㖉	𭇔
㖋	㖎
㖑	𠸴
㖤	𠷭
㖦	𰇎
㖧	㗃
㖪	𠷙
㖫	唛
㖮	𪠵
㖯	㖰
㖶	𭋡
㖾	𰇪
㗁	𰈬
㗙	𫩩
㗣	𫪺
㗤	𡄱
㗧	㗌
㗪	𠹦
㗬	𡖹
㗰	𫩛
㗲	𠵾
㗴	𪙨
㗻	𫪀
㘀	𠹠
㘉	𠰱
㘊	𡅿
㘓	𪢌
㘖	𰉁
㘚	㘎
㘠	𡇒
㘤	𡈛
㘥	𡈱
㘱	𫮩
㘽	㦳
㙁	𡎧
㙃	捠
㙊	𬔡
㙏	𪤩
㙔	𰉘
㙞	𡎏
㙡	𭎂
㙢	𰊟
㙨	𰋀
㙪	𡏃
㙫	𣙇
㙬	𫮜
㙯	𠅀
㙷	𡏀
㙺	𰊛
㙾	𰉽
㚡	𥪼
㚪	𡛋
㚹	𡜢
㛊	㛆
㛍	𡞡
㛎	𡜅
㛔	𡜠
㛗	𡟽
㛙	𨐎
㛝	𫝦
㛟	𡞵
㛫	𪥬
㛮	㛮
㛳	𢝃
㛶	𡞟
㛼	㛼
㜃	𡟤
㜄	㚯
㜌	𡠆
㜍	𡠠
㜎	𫱘
㜏	㛣
㜐	𫝧
㜞	𰌆
㜡	𫰽
㜤	𡤲
㜥	𫰨
㜪	𡣎
㜭	𫰠
㜶	𡤎
㜸	𫲖
㝁	𢏔
㝂	𧏄
㝘	𫴪
㝞	𫳃
㝣	𫲸
㝱	𤻟
㝾	𡯛
㝿	𫵏
㞄	𡯸
㞊	𡰇
㞋	𡰫
㞏	𡰹
㞐	𢨶
㞓	𡱔
㞗	𨳊
㞜	𡲾
㞨	𡵇
㞽	𡶙
㞾	屔
㟋	𡷋
㟐	㟿
㟙	𡽞
㟝	𡺈
㟟	㟡
㟢	嵜
㟦	𨋡
㟧	𰎶
㟮	𡺴
㟯	𡺀
㟰	𫶍
㟳	𦞰
㟶	㟲
㟷	𡼪
㟸	𡼗
㟺	𪩇
㠁	𫶅
㠎	㠍
㠏	㟆
㠚	𡽵
㠞	𰎾
㠦	𡾿
㠨	𡿥
㠯	㠯
㠱	𢁂
㠲	𢁦
㠹	𢂵
㠿	𢃌
㡂	𢂥
㡄	䘩
㡐	𢃬
㡞	𰏜
㡡	幮
㡥	𧞎
㡴	𫲿
㡼	㡼
㢂	𢈂
㢋	㢁
㢗	𪪑
㢣	𢍸
㢨	𢏥
㢬	𭚴
㢸	𫸺
㢻	𢏴
㢼	𡚂
㣆	𢑃
㣣	㣣
㣫	徸
㣬	𢕃
㣭	𨔩
㣽	𡚿
㣿	𢗇
㤉	𢗬
㤏	𧖂
㤗	𭜮
㤜	㤜
㤠	㤡
㤮	𢞪
㤯	𪫪
㤲	𫺁
㤴	𢛏
㤺	㤺
㤽	𪫷
㤾	𢚗
㥅	𫺚
㥏	𦖌
㥚	㤤
㥮	㤘
㥯	㦩
㥷	𰑸
㥹	𢚅
㥽	𢢻
㦀	㷨
㦁	𢣜
㦊	𫺆
㦒	𢤇
㦔	𭞘
㦖	𫺓
㦜	𫻞
㦝	𢤧
㦟	𢟆
㦠	𢙪
㦪	𢥥
㦬	𰑫
㦭	𭝋
㦴	㪾
㦺	𢾯
㧆	𫷂
㧉	𭡾
㧊	𢪹
㧏	𢲦
㧔	𫨵
㧚	𢭨
㧫	𬚏
㧬	𢭤
㧳	𢯌
㧹	𢰐
㧾	𢵃
㨁	𫩈
㨂	𫨽
㨄	𠠄
㨉	𢰞
㨊	𢸦
㨌	𰔕
㨙	𢭁
㨚	𢵀
㨛	𰓔
㨟	𫼥
㨠	𢳡
㨢	𫿌
㨥	𫽀
㨫	𫽝
㨬	𭡟
㨮	㨮
㨸	𭢼
㨻	𪮃
㩃	𢺦
㩇	𫽇
㩌	𫽧
㩓	𢶙
㩔	𫿚
㩜	㨫
㩠	𫿡
㩣	𫾉
㩩	𢹃
㩬	㩬
㩭	𫽊
㩳	㧐
㩷	𰔲
㪊	𢽏
㪋	𢽎
㪎	𪯋
㪏	𢽛
㪐	𢽲
㪑	𢽱
㪔	𢽳
㪗	敨
㪙	敤
㪛	𢾤
㪢	𢾐
㪧	𢿴
㪪	𩐅
㪫	𢿶
㪬	𭣟
㪹	𬖠
㫃	𭤨
㫎	𣄈
㫏	㫍
㫕	𣅏
㫘	𣆇
㫜	𥅃
㫝	𣅥
㫡	𣅭
㫤	㫤
㫥	𫩻
㫦	㫞
㫻	𬀿
㬂	𣈦
㬈	㬈
㬍	𣌈
㬎	𣊡
㬓	𣊠
㬙	㬙
㬟	朆
㬠	𤑣
㬣	𬀮
㬫	𣋅
㬲	𣍙
㬳	𦙗
㬴	𦚴
㬻	䐠
㭂	𣏑
㭐	𪥋
㭑	𣗌
㭕	𬻛
㭚	𣖺
㭫	𣖵
㭰	𭪿
㭼	𣒩
㭿	𢯤
㮀	㮭
㮃	𦓽
㮆	𢮡
㮇	𣕊
㮍	𪥗
㮒	𰘽
㮘	𣑔
㮟	𥓙
㮢	𣔹
㮤	𣘿
㮵	𭫛
㮶	𪲚
㮻	𢮞
㯂	𰘀
㯃	𣙉
㯄	𣗡
㯆	𰗡
㯉	𣛲
㯎	𧩋
㯛	𣝄
㯜	𬃟
㯞	𣚓
㯯	𥂃
㯳	𢐧
㯸	𰗦
㯼	𣙥
㰁	𰘾
㰃	牑
㰅	𭫙
㰈	𮟝
㰍	𬺜
㰙	𣗙
㰛	𣟿
㰟	𣢆
㰢	𣢴
㰬	𣱡
㰯	㰻
㰰	𬅢
㰳	𭭈
㰴	𣣂
㰵	𰙊
㱆	𣤼
㱒	𭭟
㱙	𭭿
㱜	𣧖
㱞	𣧉
㱟	㨢
㱠	𣧮
㱡	𭮋
㱤	𣨗
㱳	𣩎
㱴	𣩬
㱶	𣨥
㱸	𣩩
㱽	𣪄
㱾	𣪈
㲈	𰈺
㲏	𣬢
㲒	𪵙
㲔	𣮭
㲕	𰚛
㲗	𰚜
㲚	𣮅
㲞	𰚡
㲣	𣮯
㲩	𣯈
㲪	𣰆
㲫	𩯱
㲳	𣱎
㳊	𣲏
㳐	𣲞
㳘	㓍
㳦	𣸂
㳧	𭰮
㳪	𣳶
㳬	𭱕
㳾	溬
㴀	𣷸
㴇	𣷘
㴑	𣶮
㴔	𭱖
㴛	洷
㴝	𪏭
㴳	㴳
㴸	𰛛
㴽	㴮
㴿	𰛽
㵀	㶛
㵃	𣸚
㵍	𬇰
㵐	灍
㵑	𰜢
㵒	𬈕
㵚	𪷙
㵞	𣿜
㵟	𤁚
㵤	𬉇
㵨	𪷣
㵴	㶓
㵷	𤀲
㵻	𤁨
㶁	𤂆
㶄	𤅸
㶆	𫞛
㶍	𰝟
㶏	𰝋
㶖	㶖
㶗	𤀇
㶛	𤄕
㶬	𪸙
㶭	𣅺
㶷	𤈎
㷂	𤈳
㷃	𰝾
㷅	𭴻
㷈	𤌥
㷉	𤈫
㷊	𰟛
㷍	𤆢
㷏	𡚕
㷡	𤋝
㷣	𤏽
㷦	𤋕
㷬	𦹪
㷲	𰞉
㷶	𰞲
㷻	𭴊
㸂	鿪
㸈	𤒏
㸊	𬋍
㸐	𬊾
㸜	𤗇
㸮	𤘝
㸰	𧣖
㸴	𰧍
㸶	𤚕
㸸	𤙽
㸺	𬌜
㹂	𬌛
㹃	𤘿
㹍	𤠻
㹎	𤛡
㹓	𰠴
㹔	𤚖
㹕	𤛰
㹜	犾
㹝	𤜣
㹬	𧳅
㹳	𤝲
㹶	𤠜
㹺	𤠡
㹽	𫞣
㺄	貐
㺇	𤠒
㺊	𤡀
㺏	𤠋
㺒	𤠖
㺕	𤝏
㺖	𤡘
㺣	𧲘
㺤	𤢷
㺨	𤣵
㺫	𭸵
㺬	㺬
㺰	𤤚
㺾	𪻣
㻉	𤤉
㻒	𤥳
㻗	𤦅
㻯	𤨇
㻳	𫉋
㻴	𭺄
㻶	𪼋
㻷	𤤹
㻽	㻪
㻾	𤫔
㼁	𤩺
㼆	𬎆
㼈	𭹜
㼏	𰢟
㼛	㼛
㼡	𠙎
㼣	㼟
㼭	𤭥
㼮	䃀
㼰	𪾘
㼸	𤮇
㼹	𤮊
㼺	𤮂
㼽	𤭪
㼿	𤭮
㽀	𥂴
㽉	𦉞
㽊	𤮶
㽘	𤰢
㽚	𤰼
㽟	𬏃
㽠	𤲍
㽥	𰣑
㽧	𤲸
㽨	𤳶
㽹	𡁈
㽾	𤴰
㽿	𢈅
㾁	𤴷
㾅	𤴹
㾈	𬌀
㾋	𤺣
㾙	𦢯
㾛	𩒸
㾜	𤷾
㾡	𤷽
㾨	𭼝
㾫	𤺇
㾰	𤵡
㾵	𬏟
㾹	𤸍
㾺	𬏜
㿁	𤺃
㿃	䐭
㿄	𤻢
㿎	𬏷
㿗	𤻊
㿘	𤹜
㿚	𣩿
㿟	𣆆
㿧	𤽯
㿷	𥀞
㿼	㿼
㿿	𥁱
䀁	𥁓
䀈	䀈
䀉	𥁢
䀍	𰥊
䀎	𦘰
䀔	𣅉
䀟	𦕚
䀢	𬙥
䀣	䎵
䀨	𥆠
䀴	𬑏
䀻	𥇩
䀾	𥅐
䀿	䀸
䁍	𥇌
䁛	𣉨
䁤	𥊔
䁥	𦟻
䁪	𥇢
䁰	𥊾
䁱	𬑒
䁵	𥌡
䁺	𥋭
䁽	𥆁
䁿	𥊷
䂀	𥋟
䂉	𥍶
䂌	𥍽
䂍	𢑾
䂑	𥎬
䂓	𰦔
䂖	䂖
䂘	𥐟
䂚	𰦬
䂟	𥑆
䂤	𥑧
䂦	䂧
䂸	𥓛
䂽	䂪
䂾	𥓜
䃁	𰦴
䃒	𥓠
䃔	𥓰
䃗	𥓑
䃘	𬒎
䃚	𥓴
䃡	𰧢
䃢	𰧎
䃤	𬒕
䃪	𪿖
䃫	𥖷
䃮	鿎
䃲	𪿱
䃴	𰧘
䃵	𥗗
䃸	䃱
䃾	𥘇
䄁	𥘠
䄂	𰨑
䄉	𬓬
䄍	𥛾
䄐	𥛁
䄚	𥛼
䄝	𬓉
䄥	𥜧
䄨	𥝜
䄩	𥢧
䄪	𥞗
䄭	䄹
䄯	䄯
䄶	𥞳
䄿	𥹞
䅄	𥞮
䅆	𥝭
䅇	𫌚
䅊	𥝾
䅍	𥟐
䅐	𫀨
䅔	𫁁
䅢	䊘
䅣	䊗
䅥	𥠹
䅭	𥻭
䅷	䔑
䅸	𬓨
䅺	𥢕
䅾	𰨸
䆁	𬓤
䆉	𫁂
䆊	𥣕
䆍	𪚗
䆕	𥥞
䆟	㝓
䆡	𥧫
䆴	𥧄
䆵	䆸
䆸	𡪺
䆽	𥧻
䆿	𥧵
䇀	𥨳
䇁	𥩑
䇂	𬔖
䇎	𥪶
䇏	𥫉
䇑	𥪎
䇡	𬕀
䇢	𥯶
䇦	𥬺
䇫	𥭱
䇿	𫇿
䈀	𥮚
䈂	䈂
䈄	𥲌
䈍	𥭮
䈎	𥮧
䈘	𥴺
䈝	𥮪
䈢	𥯲
䈧	䈧
䈪	𥮬
䈷	𣛗
䉁	䉹
䉂	𥳮
䉈	𥷭
䉋	𥶫
䉍	𬕊
䉐	𬕛
䉑	𫁲
䉔	𥴷
䉙	𥬀
䉜	𥴢
䉟	篧
䉣	𥶘
䉥	𥵅
䉦	𥱺
䉨	𥸊
䉫	𬖁
䉭	𥶢
䉶	𫁷
䉷	𥸂
䉻	𥸳
䊓	𫃆
䊟	𰫋
䊠	䊠
䊤	𥾁
䊫	𥼺
䊭	𥺅
䊮	𥣞
䊵	𮉠
䋃	𫄜
䋆	𰬁
䋈	䋾
䋉	䊽
䋍	𰬂
䋏	𮉣
䋐	𬘙
䋑	𰬃
䋔	𫄞
䋙	䌺
䋚	䌻
䋞	𮉦
䋣	𦃍
䋤	𦆗
䋦	𫄩
䋨	䌗
䋪	䋍
䋫	𰬑
䋬	𦁔
䋷	𦃤
䋹	䌿
䋺	𬘴
䋻	䌾
䋿	𦈓
䌈	𦈖
䌉	𰫪
䌋	𦈘
䌌	𰬶
䌏	𦆥
䌐	𬘮
䌖	𦈜
䌛	𦅹
䌝	𦈟
䌞	𬘪
䌟	𦈞
䌡	𫷠
䌣	𦄮
䌧	𦀳
䌨	𦷞
䌩	𦇪
䌬	𰫞
䌰	𦈙
䍂	𦈣
䍃	窰
䍇	𦈮
䍍	𦈴
䍎	𦉙
䍐	𢆔
䍔	𦁷
䍖	𦊳
䍙	䍙
䍝	𮊇
䍡	𦌏
䍣	𦌵
䍥	𣌅
䍨	𦍜
䍭	𬙰
䍮	𦎉
䍱	𦍗
䍶	𤟈
䍷	𬙭
䍺	𦏖
䍼	𦏋
䍾	𦏹
䎀	𦐴
䎂	𦐙
䎊	𦐦
䎌	𬚃
䎖	𦒗
䎙	𫅭
䎡	𨅲
䎢	𦓪
䎤	𦔁
䎫	𦔕
䎮	𦔝
䎱	䎬
䎺	𦕶
䎿	𦖣
䏀	𦖨
䏅	𦕀
䏆	𦗠
䏇	𦗩
䏊	𰭹
䏌	𰮀
䏐	𦚀
䏕	䏕
䏖	𦙢
䏘	𦙬
䏚	𦙧
䏞	𦚜
䏠	𦚎
䏢	𦚆
䏣	𰮘
䏤	𠈀
䏶	𦜣
䏺	䏾
䏼	𰮦
䏽	𦜟
䐁	𦜼
䐃	㬷
䐋	䐋
䐐	𦝱
䐗	𬛃
䐚	𬛋
䐷	𬂅
䐹	𰮲
䐼	𦝜
䐽	𰯎
䑎	𦢙
䑏	𦝢
䑗	𬛹
䑤	𦨽
䑪	䑥
䑫	䑫
䑱	𦨨
䑽	𦪙
䒇	䒄
䒌	𦫮
䒍	𦫣
䒓	𦫼
䒞	𦬍
䒦	𦭢
䒸	𦶯
䒼	𦮒
䓈	𦲴
䓙	𦴂
䓛	𥮝
䓠	𦵺
䓣	𦲸
䓥	𠌓
䓲	𦲮
䓺	𤎀
䓻	𦽛
䔀	𦵭
䔄	𦾾
䔇	𰰴
䔈	𰱀
䔌	𦺆
䔑	𦳃
䔘	𧃘
䔜	𦶈
䔴	𦿎
䔶	𦻀
䔷	𧂖
䔸	𦼐
䔹	𧁂
䔾	藒
䕆	𦸄
䕈	𦺯
䕍	𧃥
䕕	𧂧
䕙	𦿐
䕝	䕝
䕟	𦮚
䕣	𦼵
䕤	𫟕
䕦	𦻯
䕭	𧂞
䕲	𦾰
䕴	𧄄
䕸	𦷓
䕹	𰰶
䕻	𧅳
䖀	𰲖
䖂	𧄶
䖅	𫟑
䖆	𧅼
䖒	𧆲
䖔	𧇦
䖕	𧇇
䖗	𧇱
䖚	𰲟
䖠	𬟵
䖧	𤷈
䖭	𫊲
䖴	𧎼
䖵	䐊
䖶	䝅
䖺	𧌁
䗅	𫊪
䗋	𧋟
䗒	𧏑
䗓	𧋙
䗗	䗗
䗛	𬠡
䗜	𧏓
䗥	𰲯
䗫	𧔕
䗯	𧎽
䗴	𰪛
䗷	𧕢
䗸	𧒱
䗹	䗹
䗻	𮔂
䗽	𰳚
䗿	𧉞
䘏	𨜧
䘬	𮁱
䘵	䘵
䘸	𧜥
䘺	𬓆
䙃	𧝍
䙄	𧚎
䙅	䌁
䙌	𧝷
䙕	𧛝
䙜	𧜨
䙝	𧃳
䙡	䙌
䙥	鿅
䙦	𧜩
䙮	䌯
䙱	𧜭
䙳	𧟧
䙹	𧠻
䙼	𰴖
䚂	𧹦
䚃	𧡹
䚅	𧡛
䚆	𬢑
䚌	𧢌
䚍	𧢔
䚎	𧢆
䚐	𧡐
䚔	𧢘
䚗	𧢸
䚙	𧣰
䚜	𧤃
䚣	𧤘
䚧	𧥂
䚭	𧤆
䚯	𠮧
䚳	𬣛
䚴	𧦗
䚵	𬣟
䚷	𧦉
䚹	䚰
䚺	𬢟
䚻	𧦇
䚽	𬣜
䛀	𰵐
䛇	䛇
䛍	𬣧
䛎	𧦱
䛒	𧭿
䛔	𧦀
䛘	𬣯
䛛	𬣬
䛞	𬣸
䛟	𰵢
䛣	𫪆
䛤	𬣹
䛳	𫍫
䛴	𮘩
䛿	𬤑
䜀	䜧
䜄	𰶈
䜇	𧫀
䜈	𧭄
䜍	𬤟
䜎	𬣿
䜐	𧨧
䜒	𬤡
䜖	𫟢
䜝	𬤬
䜱	𧯐
䜷	𬤸
䜼	𧯸
䜾	𧯹
䝀	𰶡
䝃	𧰁
䝄	𧰤
䝈	𧱒
䝌	𧱝
䝒	𧱛
䝟	𧳳
䝡	𬥊
䝢	𧴝
䝧	賯
䝪	𧶳
䝭	𫎧
䝰	𧶱
䝹	𮚉
䝺	𪯢
䝼	䞍
䞀	𬥽
䞁	𬥺
䞃	𰷏
䞉	𰷩
䞋	𫎪
䞓	𫎭
䞔	𧹧
䞕	𧹸
䞖	𧺱
䞚	𧼘
䞛	𧺪
䞞	𧼗
䞤	𠹪
䞧	𧼵
䞫	𧼐
䞭	𨕦
䞰	䟄
䞾	𧼥
䟄	𨖊
䟅	𧽯
䟆	𫎳
䟇	𧺋
䟊	𰷾
䟌	𧽭
䟍	𧾫
䟏	𰷴
䟘	𧿦
䟠	𨃂
䟤	𧿥
䟩	𨅫
䟴	𬅾
䟵	𨁛
䟸	䠏
䟿	𨄭
䠀	䟫
䠄	𨆁
䠅	𨁉
䠇	𠡰
䠑	𨅆
䠙	𨁳
䠧	𮜌
䠨	𨅧
䠩	𰸊
䠮	𬧃
䠶	𪿎
䠸	𨉀
䠼	𧙠
䡀	𨊈
䡁	𬧢
䡆	䡥
䡇	𰹷
䡈	𬧶
䡊	𰹺
䡏	䡌
䡐	𫟤
䡑	䡻
䡔	𨌋
䡕	𨍗
䡜	𨎈
䡞	𨍯
䡣	𨏂
䡦	𬨑
䡩	𫟥
䡫	𨏕
䡬	𰹥
䡳	傂
䡴	𰺝
䡶	𬨔
䡹	𬨕
䡺	𨎥
䡻	𰺤
䢃	𬂘
䢈	𰺭
䢋	䢎
䢌	𨒠
䢑	𨑼
䢒	𧻨
䢙	𰇩
䢚	𨁈
䢡	𨔋
䢵	𨝽
䢼	䣏
䢾	𨚁
䣂	洡
䣄	𨝛
䣅	𫑥
䣔	𨝉
䣕	䣖
䣗	𨝲
䣙	剻
䣛	𨞢
䣩	䣨
䣫	𨠃
䣹	𨠰
䣿	𨡖
䤇	𰼇
䤌	𮠞
䤎	𪊀
䤐	𰼓
䤓	𨢊
䤙	𨣰
䤠	𰽠
䤡	𬫉
䤤	𫟺
䤥	𰽺
䤩	𬭈
䤴	䥁
䤵	𰾐
䤸	𰾦
䤹	𨨿
䤻	𰾖
䤼	𬭣
䥀	𨩪
䥄	𫠀
䥇	䦂
䥋	𨬤
䥏	𨯣
䥒	𨯞
䥕	𬭯
䥖	𰾻
䥗	𫔋
䥛	𬭴
䥞	𬭻
䥢	𫓖
䥧	𨬴
䥩	𨱖
䥪	𫓣
䥰	𨨸
䥱	䥾
䥴	𰿅
䥷	𰿇
䦊	𨲂
䦋	𨲶
䦎	𰿨
䦏	𨳚
䦐	𫼓
䦕	䦕
䦜	𨵒
䦝	𬮨
䦟	䦷
䦯	𫔵
䦳	𨷿
䦹	𨙩
䦻	𱀂
䦽	𫕃
䧁	𱀉
䧑	𱀔
䧙	𮥑
䧞	𬮺
䧨	𨼙
䨂	𪝲
䨇	𫪉
䨈	𱁏
䨊	𩁵
䨘	𬰄
䨛	𩄜
䨜	𬯿
䨯	𩄛
䨸	𬰔
䨼	𩇥
䨽	𩇯
䨿	𩇺
䩁	𱁯
䩂	𩈖
䩊	𩈱
䩐	𩉟
䩒	𩉞
䩕	𩉰
䩖	𩊮
䩛	𩉫
䩤	䩐
䩦	鞗
䩪	䪀
䩫	𬰥
䩮	䩮
䩯	𩏊
䩶	䩶
䩼	𩊩
䪊	𫖅
䪍	𱁽
䪎	𩍺
䪏	𩏼
䪐	𱂅
䪑	𩎼
䪓	𬰳
䪔	𩏮
䪘	𩏿
䪜	𬰷
䪝	𱂌
䪞	䨿
䪣	䪟
䪥	𱂎
䪬	𥩾
䪲	䪲
䪸	𩕻
䪹	䫊
䪻	𩓉
䪼	𱂢
䫂	𫖰
䫄	𩒬
䫈	𬱣
䫉	𬥈
䫐	𬃲
䫔	䚉
䫗	𢝄
䫟	𫖲
䫥	𱆚
䫬	𩕗
䫯	𩕲
䫴	𩖗
䫸	𩖙
䫻	𫗇
䫼	𬱷
䬀	𱃖
䬂	𬱸
䬆	𩘟
䬋	𱃃
䬎	𬱿
䬏	𱃆
䬓	𫗊
䬔	𱃞
䬜	𱃎
䬠	𩄩
䬧	𫗟
䬬	𱃵
䬯	𬲫
䬰	𥹙
䬶	𬲷
䬷	𩜉
䬹	𱃸
䬽	䭨
䬾	𬲻
䬿	𩜧
䭅	𬲾
䭇	𬳀
䭒	𬳋
䭙	𩞲
䭞	𬲳
䭣	𬲶
䭤	𩝡
䭦	𪎄
䭩	𫗗
䭫	䭬
䭬	𩠜
䭷	𰚧
䭹	𩣍
䮄	𫠊
䮈	𬳾
䮉	𩥜
䮎	𩥀
䮚	𩜁
䮝	𩧰
䮞	𩨁
䮠	𩧿
䮤	𩧏
䮦	𩥊
䮧	𱅠
䮫	𩨇
䮰	𫘮
䮲	𱅦
䮳	𩨏
䮵	𩦍
䮷	𩧈
䮸	𬳸
䮻	𮪇
䮽	𬴍
䮿	𬴏
䯀	䯅
䯂	𥤡
䯈	𩩁
䯌	𩩾
䯎	䯎
䯔	𩨛
䯘	𩩕
䯜	𤓑
䯣	𩪹
䯤	𩩈
䯦	𩪻
䯨	𩫀
䯰	𩬐
䯱	𩬋
䯼	𩭲
䯾	𩯦
䰂	𩭄
䰃	𩮗
䰈	𩯸
䰉	䰔
䰌	𨲧
䰍	𥿴
䰐	𱆅
䰘	𨶪
䰙	鈘
䰛	𤭁
䰧	𩳰
䰩	𩴟
䰪	𩳬
䰫	𱆙
䰬	𩴢
䰯	𩴷
䰲	𱇍
䰷	𬶆
䰼	𩷒
䰾	鲃
䱂	𱇤
䱅	𱇚
䱇	𱇞
䱌	𱇬
䱏	𩶃
䱐	𱇲
䱓	𬶓
䱕	𧉯
䱙	𩾈
䱚	𮬠
䱛	𮬟
䱟	𱈀
䱤	𱇻
䱥	𱇹
䱧	𫚠
䱩	䰶
䱭	𱈇
䱰	𩾋
䱴	𱈈
䱵	𮬢
䱽	䲝
䲀	𩻉
䲁	鳚
䲉	𱈒
䲋	𮬖
䲌	𩺶
䲏	𬶗
䲕	𬶴
䲖	𩾂
䲗	𮬣
䲘	鳤
䲙	𬶎
䲢	䲍
䲣	𮫱
䲤	鿐
䲦	𩿁
䲨	𬷾
䲪	𩾪
䲰	𪉂
䲱	鴋
䲻	𪈉
䲼	𬸆
䲽	𡫰
䳇	𱉞
䳏	𱉤
䳑	𫚸
䳒	𱉧
䳙	𩿭
䳜	𫛬
䳝	𨿦
䳧	𫛺
䳩	𩀄
䳫	𫛼
䳸	䳸
䳺	𱊣
䳻	𩀧
䳿	𪆈
䴀	𪆏
䴃	𩀸
䴇	𱊪
䴈	𬸩
䴉	鹮
䴋	𫜅
䴎	𤡂
䴤	𪊟
䴥	𢉻
䴪	𪋵
䴮	𱋆
䴯	𪍃
䴴	𪎋
䴵	𱋔
䴸	𱋗
䴻	𪍆
䴽	𫜔
䵀	𪍨
䵃	𱋫
䵄	𥽈
䵆	𱋮
䵈	𣫓
䵋	𪏞
䵍	𪏆
䵏	𪏧
䵐	𱋴
䵔	𪐈
䵘	𬓸
䵡	𪐡
䵵	𧅌
䵷	𱌃
䵺	𡒧
䵻	𪔊
䵿	𧰀
䶂	𪕺
䶃	𪕛
䶅	𪕘
䶆	𪕪
䶒	𠆈
䶔	𪗩
䶕	𫜨
䶗	𮯙
䶝	𪘘
䶞	𪗞
䶤	𩪲
䶦	𬺉
䶧	𱌰
䶯	𡤞
䶳	𤒀
䶾	𣢧
䶿	飢
丁	𠆤
丈	𠀋
三	𫧁
丙	𠱛
东	東
丢	丟
丨	⼁
丬	⺦
丵	𦭱
丶	⼂
丿	⼃
乀	㇏
乁	乁
乂	䢃
么	麽
乕	𠂰
乚	⺃
乛	⺂
乞	𠧒
习	習
乣	糺
乼	𨦤
乿	𠄂
亀	⻲
亄	𠃸
亅	⼅
云	雲
亜	𠥲
亠	⼇
亳	𠅢
亶	𮧊
亻	⺅
亼	亽
仃	𫣨
仉	𠆰
仌	仌
仐	𠓝
他	𬽲
仗	杖
仛	𠇔
仝	𠚤
仟	𭛜
仡	㐹
仯	仦
仲	㑖
仳	㑭
仹	𠉏
任	𢓩
份	分
伃	𠇐
伉	𬽶
伋	觙
伎	𠇞
伡	俥
伢	𤘅
伣	俔
伥	倀
伧	傖
伭	𠆺
伯	𰐭
伴	㚘
伺	𣱇
伾	伓
伿	㑆
佁	𫩞
佃	畋
但	亶
佉	𠳞
住	𥩣
佔	占
佖	𠉘
佪	𠇶
佮	𫧻
佰	伯
佸	𠈲
佾	𢔍
侅	𠇟
侒	𠊢
侔	𠉖
侗	㣚
侜	𰂉
侠	俠
侣	侶
侭	儘
侳	𠋿
侴	𠜋
侶	侣
侷	𠉧
侸	𠍄
侻	侻
俄	𭀁
俅	𤞰
俚	𨛋
俜	𠏬
俠	侠
俥	伡
俫	倈
俴	𠈙
俶	埱
俸	奉
俺	𰁱
倀	伥
倄	𬾝
倅	伜
倆	俩
倈	俫
們	们
倓	𠋴
倕	𠍮
倖	𰂘
倜	俶
倠	𠈆
倨	𭩢
倯	𢔋
倰	𪌒
债	債
偉	伟
偋	𠌸
偑	㐽
偒	𠏑
偙	僀
做	作
偞	𠉪
偠	婹
偩	𰁾
偪	𫯫
偯	㥋
偲	愢
偳	𠉺
側	侧
偵	侦
偿	償
傂	𠈩
傇	𠐪
傊	𠋏
傌	㐷
傏	㑽
傕	𠐶
傖	伧
傝	𠎷
傞	𠊡
傤	儎
傥	儻
傪	𫢺
催	𫣐
傮	𠑤
傴	伛
債	债
傷	伤
傺	𬿺
傾	倾
僀	𰂗
僁	𠋱
僂	偻
僅	仅
僈	𣍑
働	𫢙
僎	𠊨
僑	侨
僓	𰂜
僖	釐
僗	𫢬
僛	𠐾
僞	伪
僢	𠌏
僣	𦅦
僤	𫢸
僨	偾
僯	䫰
僴	𰂋
僸	嬐
僻	𠒱
儀	仪
儂	侬
億	亿
儅	𰁸
儆	憼
儈	侩
儎	𪝠
儔	俦
儖	𫣉
儜	佇
償	偿
儣	𬽷
儥	𰂏
儩	𰂭
優	优
儭	𠋆
儰	𫢭
儲	储
儶	㒞
儷	俪
儸	㑩
儺	傩
儻	傥
儽	㒍
儾	𦈃
兂	𠑶
児	𫤗
兖	兗
兙	𠒲
党	黨
兛	𠒙
兞	𠒭
兡	𠒘
兣	𡪸
入	⼊
兰	蘭
冁	囅
冃	⺜
冄	𭃂
冋	𫡃
冑	𰼾
冖	⼍
冧	𫫋
冪	𬝙
冫	⼎
冯	馮
冶	𠘦
冻	凍
冼	洗
凊	𫥝
凋	雕
凍	冻
凐	𠗃
凓	𠘍
凘	𠗧
凙	𪞝
凞	凞
凟	𰃿
凱	凯
凼	氹
刂	⺉
分	𭄞
刍	芻
刏	𧗒
刕	𭃊
刜	𭃾
刢	𫢣
刭	剄
刵	𠠨
刽	劊
刿	劌
剀	剴
剄	刭
剅	𧯠
則	则
剉	𠞐
削	𨨺
剗	刬
剛	刚
剠	㔀
剦	𠞒
剮	剐
剴	剀
剷	剷
劄	箚
劆	𠠟
劇	剧
劊	刽
劋	𠟯
劌	刿
劏	㓥
劚	㔉
办	辦
劢	勱
劥	𠠺
劰	𠡈
劵	𠢏
劶	㔚
劸	𠡬
効	𰋶
劺	敄
劻	𤝿
勁	劲
勍	𠡽
勑	𠡠
勜	𩔚
募	𭄭
勡	𠣆
勣	𪟝
勦	𣩓
勮	𭄾
勰	𢣢
勳	勛
勷	𮠍
勹	⼓
勻	匂
匌	𫎀
匍	蒲
匕	⼔
匦	匭
匨	𫧔
匩	𠥆
匭	匦
匰	𰅦
匴	𥮞
匵	𰅥
匶	𫡹
匸	⼖
十	⼗
卝	艹
卟	𠮝
卧	臥
卲	𬍨
卻	𨜪
厍	厙
厎	㕄
厖	𠩇
厗	𥔈
厙	厍
厠	厕
厣	厴
厤	𠩵
厫	𠪭
厬	𣽞
厯	𠪾
厱	𰆚
厴	厣
厶	⼛
厹	𠃙
叉	扠
叓	㕝
取	𬚓
叭	𠵺
可	𠍟
叴	㕤
叵	尀
叶	葉
司	𤔲
吂	𠴏
吉	𠮷
吐	唋
吒	𮤹
吗	嗎
吢	𢙈
吰	𠴈
吱	𭇅
吳	吴
呀	㗇
呁	𠹚
呂	吕
呐	吶
呒	嘸
呔	𠯪
呖	嚦
呛	嗆
呰	啙
呶	詉
呸	咅
呺	𧦢
呿	𠳷
咃	𠴻
咈	𠲽
咓	𠱏
咛	嚀
咜	𠰹
咝	噝
咞	咞
咡	㖇
咥	𠽧
咦	𠲔
咮	𠰍
咰	𠲾
咲	𠹻
咵	𫪖
咶	𠳂
咸	鹹
品	𠯮
哅	㕼
哈	𨉣
哌	𠸁
哒	噠
哖	𫩰
哙	噲
哚	𫩴
哛	兺
哞	𪡂
哟	喲
員	员
哥	𤔄
哩	唎
哪	㖠
哹	𠸷
哼	𡃥
哽	𠶺
哿	𠵲
唂	唃
唄	呗
唆	𪡟
唓	𪠳
唝	嗊
唠	嘮
唡	啢
唢	嗩
唣	唕
唫	𠱴
唰	𠴪
唻	𫪁
啉	𠵂
問	问
啗	㗖
啦	𪠸
啩	𫫔
啪	㕷
啭	囀
啯	嘓
啰	囉
啴	嘽
啷	𪡙
啽	𠹞
喁	𠷸
喅	𪢄
喎	㖞
喐	閄
喔	噢
喗	𠲰
喠	𠳀
喢	𠴯
喤	𠹡
喦	𠹜
喬	乔
喭	𣨹
喲	哟
喺	𫪈
喻	喩
嗆	呛
嗈	𭈊
嗉	膆
嗋	𡀺
嗎	吗
嗐	𠷪
嗚	呜
嗢	嗢
嗦	𫧫
嗧	𰇠
嗫	囁
嗰	𠮶
嗳	噯
嗴	𫪾
嗶	哔
嗹	𪡏
嗺	哸
嗼	𠻶
嗿	𰇲
嘀	唙
嘂	𠼨
嘌	𡄺
嘍	喽
嘎	嘠
嘐	𡀒
嘑	𠻢
嘔	呕
嘙	𭒂
嘜	唛
嘟	𬅩
嘡	镗
嘩	哗
嘪	𪡃
嘮	唠
嘰	叽
嘲	謿
嘳	𪡞
嘸	呒
嘹	𠺕
嘺	𪡀
噂	譐
噌	𧯒
噑	噑
噚	㖊
噜	嚕
噠	哒
噮	𠾪
噯	嗳
噰	𡄸
噳	𰉋
噸	吨
噹	𪠽
噾	𠽨
嚃	嚺
嚆	𭌬
嚈	𫩫
嚊	𠱢
嚌	哜
嚍	𫩺
嚐	𰈇
嚓	𰌵
嚔	𠳍
嚙	啮
嚛	𪠸
嚠	𭇯
嚥	𨽞
嚧	𠰷
嚨	咙
嚪	𫫦
嚫	𰈍
嚬	𫫾
嚲	䯬
嚹	𡅈
嚺	𡃱
嚽	𪢕
嚿	𫩥
囅	冁
囇	𫪃
囈	呓
囑	嘱
囔	𰀉
囕	𰈆
囗	⼞
囧	𭍛
囫	𰿜
囷	𡈀
囹	囹
囿	𡈹
圂	𰈔
圄	圉
圜	𰫶
圠	𫭖
圢	䵺
圩	墟
圭	珪
圱	圲
圹	壙
圻	㙨
坁	𭎁
坄	垼
坌	𡛑
坦	憻
坨	𫡢
坩	㽍
坪	𡊞
坫	𡊜
坭	𫭺
坶	㙁
坷	𬍯
坹	䆷
坿	𬔪
垅	壠
垆	壚
垇	𡊐
垐	㘹
垑	𡋝
垗	𤱩
垜	𣐟
垝	陒
垩	堊
垱	壋
垶	㙚
垷	𰉚
垻	坝
垼	𡋸
垽	㴈
垾	𮥈
埂	𡎩
埃	𢚝
埄	𡓄
埅	𨹛
埈	𰉿
埉	𰉥
埊	𭯼
埏	𡑋
埐	𡎹
埘	塒
埡	垭
埣	𡉻
埩	埥
埪	𡌾
埬	𪣆
埯	垵
埲	埄
埳	塪
埵	𡑊
埼	𫮍
埾	𡒍
堃	𡑔
堈	𰉙
堍	堍
堒	𫮞
堝	埚
堢	𰊏
堣	𬴣
堧	𪣳
堨	𡑷
堩	𡍷
堪	𢦟
堲	堲
堳	𬛾
堹	𫝟
塀	塀
塆	壪
塊	块
塋	茔
塏	垲
塓	㨠
塘	䧜
塙	𣤇
塜	塚
塢	坞
塤	𡎖
塨	𤨶
塩	𫞱
塬	原
塭	𪤂
塯	㙧
塲	㘯
塳	塜
塴	𰎱
塵	尘
塷	𡌓
塹	堑
塽	𡑽
塿	𪣻
墆	𰊂
墌	坧
墏	𰊈
墐	𡒣
墜	坠
墝	𫭪
墟	𭢉
墡	磰
墤	𡓤
墧	𰉩
墬	墬
墯	𫻃
墲	𪢸
墷	𰉪
墾	垦
壆	㙾
壈	𡒄
壋	垱
壍	𰊢
壗	𡋤
壙	圹
壛	𰊡
壝	𭏸
壡	𫫽
壩	坝
壬	𡔛
壴	𧯛
壷	𠻭
夂	⼡
夊	⼢
夋	𭆙
夢	梦
夰	㚏
夻	㕦
奀	𡗗
奅	𡘣
奒	𡙓
奓	偧
奕	𤓖
奝	𠶰
奠	𠪝
奤	𩔈
奮	奋
奲	𫰂
奺	𡚮
奻	𡠛
奼	𡛥
妈	媽
妗	𡢳
妝	妆
妞	㚼
妟	𣅓
妠	𡜴
妤	𭑴
妦	㛔
妨	𡍀
妪	嫗
妯	𠉩
妶	娹
妾	㛙
妿	㚳
姆	娒
姍	𡜜
姑	𬕲
姘	姘
姚	𡜞
姝	𡚾
姞	𡜩
姟	𡛅
姡	𡜶
姣	㚣
姦	奸
姨	𫰆
姩	𡝟
姭	𪥺
姮	𫰟
姰	𡟱
姱	𡝻
姼	𡚼
娀	𡞨
娂	妅
娅	婭
娆	嬈
娇	嬌
娍	𡡛
娎	𡝊
娐	𡣷
娒	𫱙
娓	𮘕
娔	𡞢
娖	孎
娛	娱
娜	𡟦
娣	𡠨
娥	䄉
娧	娧
娶	𡣞
娸	𡞑
娹	婱
娼	𡝭
娽	𡝘
婎	𡠓
婕	媫
婘	𡤡
婡	𫝫
婢	婢
婣	𫰿
婧	婙
婩	𡛢
婭	𫰫
婳	嫿
婶	嬸
媁	𫰍
媄	𭒏
媇	𪦖
媈	𫝨
媔	𡞎
媜	𰌂
媞	𡠕
媣	𡜉
媤	㚸
媦	𡣃
媨	𡞜
媩	𡛚
媪	媼
媮	婾
媱	𡝛
媳	𡡁
媽	妈
嫁	𧱌
嫄	𡞼
嫇	𡢌
嫏	𡟧
嫐	娚
嫒	嬡
嫕	𡡌
嫘	𡤯
嫙	𡡍
嫛	𡤖
嫞	𫲒
嫪	𢚄
嫯	𰌚
嫳	𡡹
嫻	娴
嫼	𡣫
嫽	𡢴
嫿	婳
嬀	妫
嬂	𡛰
嬅	𫰡
嬆	𡡽
嬇	𫝬
嬈	嬈
嬉	繥
嬋	婵
嬌	娇
嬍	𫲈
嬒	𫰢
嬘	𡟝
嬛	𡣱
嬡	嫒
嬦	𫝩
嬨	嬨
嬬	𡢉
嬮	𰋽
嬳	𡤬
嬵	婂
嬻	𪥿
嬼	㚹
孃	嬢
孄	𫝮
孆	𫝭
孇	𪥫
孈	𡣸
孉	𡢸
孎	𡠟
孚	𤓽
孩	㜾
孫	孙
孬	𪥸
孭	𧴯
孯	𪧂
孲	𰌦
孷	𡥽
孻	𡥧
孾	𪧀
孿	孪
宀	⼧
它	牠
宋	𠳼
宔	𥘭
宖	𥥈
宗	𠖀
客	𪧒
宮	宫
宲	𪧌
寃	𡨘
寖	𩅕
寗	𫳬
實	实
寪	𰌷
寫	写
寬	宽
寸	⼨
寺	䦙
尀	𡬡
尅	𣲊
尋	寻
尐	𧉍
尖	鑯
尗	𰍪
尛	𡭯
尜	嘎
尮	𡯦
尲	凲
尷	尴
尺	斥
尼	𡰱
层	層
屆	届
屍	尸
屓	屃
屨	屦
屪	𣬝
屬	属
屭	𠫍
屰	𭁄
屴	𡴽
岂	豈
岃	塖
岈	𡵥
岌	圾
岏	𡵧
岑	𡻿
岔	䟕
岢	㞹
岣	𡵺
岦	𡶧
岪	𡶒
岮	𡶊
岱	𰁶
岲	𡶢
岵	𠰛
岶	𣶎
岽	崬
峀	峀
峂	𡶞
峄	嶧
峇	𡸡
峒	峝
峔	𡶰
峖	𫵻
峛	峢
峦	巒
峬	𭖢
峲	𡸉
峳	𩥘
峴	岘
峸	𡷫
峿	𡷤
崂	嶗
崃	崍
崆	𡹝
崋	𪩓
崌	𭖱
崍	崃
崑	崐
崝	𡸺
崠	𰎏
崨	𡹈
崬	岽
崰	𡸟
崽	仔
崾	岆
嵂	𡷏
嵏	嵕
嵕	𡽀
嵧	𫶌
嵫	嵫
嵱	𫶎
嵳	𭖾
嵴	𡹒
嵹	𡾪
嵺	𡻪
嶁	嵝
嶄	崭
嶈	𡺃
嶍	㠄
嶕	嶣
嶖	𭖺
嶗	崂
嶛	嶚
嶠	峤
嶤	𰎔
嶨	峃
嶩	𰎞
嶬	㠖
嶲	嶲
嶸	嵘
嶹	𫝵
嶼	屿
巆	𫶕
巒	峦
巔	巅
巚	𰎹
巛	⼮
巧	𢩨
巯	巰
巰	巯
巳	⺒
巴	𢀳
巻	𪩫
巿	𡴄
市	𡊔
帅	帥
帉	𢁥
帊	𢁡
帏	幃
帡	帲
帨	帨
帳	帐
帴	𰏕
帿	𢃨
幀	帧
幓	㡎
幖	𢅽
幗	帼
幘	帻
幛	障
幝	𪩷
幦	𧜀
幧	㡑
幪	𢄐
幮	𢅥
幯	擳
幱	𰏟
幷	𢆙
庀	䚹
庇	𠨽
庉	𢇠
庍	𢇩
庘	𤵭
府	𢇯
庝	𠩁
庠	𫨇
庡	㕈
庢	厔
庣	𠩓
庥	𢊒
庨	𨴹
庫	库
庲	𫷬
庿	𫳝
廀	𢊈
廁	𰣷
廂	𫷭
廅	㕎
廈	𪪜
廋	廀
廐	𫳷
廔	𫷹
廕	𫷮
廖	𭙏
廜	𢉜
廠	厂
廥	𰏶
廮	𫷾
廲	𢌒
廴	⼵
廹	𫨷
廻	廽
弎	𢦘
弐	𭚟
弔	𢎱
弜	𢻚
弣	㓡
弧	𥏩
弨	𢐕
弩	𭚯
弪	弳
弫	𢏈
弯	彎
弳	弪
弽	𬀗
彃	𪪼
彄	𫸩
彇	𢑁
彈	弹
彊	𫕘
彎	弯
彛	𡚋
彠	彟
彡	⼺
彤	蚒
彫	彫
彯	𢒵
彲	彨
彳	⼻
彷	徬
彼	佊
彽	𢓎
律	律
徎	侱
徑	径
徕	徠
徛	𢕗
徜	倘
徠	𰻎
徦	𢔾
徧	𭛷
徨	𬗬
徬	𢔚
徱	𢖣
徴	𫶑
徶	𠍯
徻	𢕺
徿	𪫌
忄	⺖
忆	憶
忐	憳
忕	𢗗
忖	刌
忛	𢖾
忤	午
忨	𫹵
忪	𢪌
忭	昪
忲	㥭
忶	𢣒
忸	𩈇
忹	忹
怄	慪
怆	愴
怊	𫺕
怖	悑
怗	㤐
怙	𢛅
怟	𢗝
怤	懯
怦	㥊
怩	𢘒
怫	𢘍
怭	𰑒
怰	𢜚
怴	𪬻
怵	𪫟
怽	𭘕
怿	懌
恀	忯
恃	𢘥
恇	𢝎
恊	𭜴
恔	㤊
恕	㣽
恚	㤬
恛	𭝽
恣	𢙊
恥	耻
恬	𢙖
恺	愷
恽	惲
恾	𦮝
恿	慂
悀	愑
悂	𢟵
悄	𢖹
悅	悦
悆	𢚒
悇	𢣿
悈	𢜾
悏	𫺂
悛	㥗
悢	𢝋
悧	𢤆
悭	慳
悮	悞
悱	㥱
悵	怅
悹	悺
悺	𢛙
惀	𰑄
惁	𢜣
惑	𤐉
惓	𫺉
惙	𭛶
惚	𢝻
惩	懲
惱	恼
惸	𢝼
惹	𢜪
惻	恻
惼	𭞒
惾	𢣌
愀	𭛻
愇	𫹴
愋	㦥
愌	𢚾
愑	愹
愒	𢢚
愗	𢝽
愜	惬
愝	𫺍
愠	慍
愣	睖
愯	𢥠
愴	怆
愻	𢙏
愾	忾
慂	惥
慆	𫺼
慉	槒
慊	𰒑
態	态
慍	𭝾
慏	𢟫
慓	𢥡
慔	𢞹
慙	𰑧
慚	惭
慣	惯
慤	悫
慪	怄
慫	怂
慬	懄
慱	𰑁
慳	悭
慷	忼
慸	𰑵
慼	㥻
慿	𠗦
憀	𢟺
憃	𢠅
憄	𢕞
憊	惫
憌	𢗋
憍	㤭
憒	愦
憕	𢘌
憖	憗
憚	惮
憛	㤾
憡	𢙀
憢	𢙒
憣	𢟷
憦	𫺘
憫	悯
憮	怃
憴	𰑪
憶	忆
憻	𪬹
憽	𢤄
憾	𰑞
憿	㦘
懁	𢟿
懇	恳
懊	㤇
懓	𭞄
懖	𢤌
懝	𢣕
懢	𪬌
懧	㤖
懩	𫺪
懱	𰒢
懺	忏
懾	慑
戃	𰑿
戄	㦜
戅	𥫒
戇	戆
戈	⼽
戊	𭠍
戋	戔
戍	𭚠
戕	𢦤
戙	𭟳
戜	𢧄
戡	𢦟
戣	鍨
戥	等
戧	戗
戫	𭲼
戯	戱
戰	战
戲	戏
戵	𢎖
戶	户
戺	𢨪
戻	𭠅
扌	⺘
扏	㧨
扒	掱
扔	𢫨
扟	𢩫
扢	㧉
扤	𢪁
扯	撦
扲	𫾵
扳	𢲔
扻	𬅝
抇	𢪏
抈	𪱙
抋	𢱶
抍	㐼
抒	捈
抓	𪭼
抔	㧵
抠	摳
抡	掄
抦	㨀
抬	擡
抮	𢷑
抴	𠂆
抸	𢪍
抹	𢳀
抺	𫨴
抻	捵
抾	𢬱
抿	呡
拁	㧝
拇	胟
拈	𢫈
拊	捬
拌	秚
拏	拏
拢	攏
拧	擰
拪	𪠧
拫	𪭳
拭	𢂑
拮	𢮌
拲	㭟
拴	絟
拷	𣧏
拹	𭠱
挆	挅
指	𢫾
按	案
挎	𩣔
挒	𢴴
挓	𢵍
挕	𫾬
挜	掗
挝	撾
挢	撟
挬	𢰏
挭	𪯍
挮	䶏
挺	𫡖
挻	𫾷
挾	挟
捀	𢪋
捁	𬆧
捅	㪌
捇	𢷓
捊	抙
捋	寽
捐	捐
捒	𬆥
捙	𬨀
捚	𬥋
捛	𫼴
捡	撿
捤	𢭶
捨	捨
捫	扪
捺	𭡠
捿	𪮄
掁	𰓄
掄	抡
掇	𢬏
掉	𢴿
掍	𣬑
掎	𢰤
掐	𭶫
掓	𰓹
掗	挜
掙	挣
掚	𪭵
掛	𨩥
掞	𢴵
採	𭡽
掮	𠊘
掹	擝
掼	摜
掾	𫩁
揀	拣
揈	㧦
揊	𢾇
描	𫿁
提	𭓒
揘	𫿃
揙	𭢬
揝	𭡗
揟	𢪵
握	𦥆
揤	揤
揧	𥻌
揱	𣕇
揳	𢰟
援	𠋠
搀	攙
搁	擱
搂	摟
搇	𠹸
搈	𪠮
搉	㩁
損	损
搓	𢷼
搕	𢾩
搖	摇
搗	捣
搞	𢲤
搢	搢
搤	𬐭
搧	𢲒
搭	撘
搯	𠞞
搲	攨
搶	抢
搸	𢸩
搻	𫣘
搽	𢴉
摀	𰓆
摃	𫼱
摅	攄
摌	𫼪
摑	掴
摒	摒
摖	𢲉
摛	攡
摝	𢮑
摟	搂
摣	𢳛
摥	𫼟
摨	𭡱
摯	挚
摱	𢶔
摲	𰓼
摳	抠
摴	摢
摵	𡠽
摹	𢸆
摻	掺
摾	摾
撄	攖
撊	𪭾
撋	𰓷
撓	挠
撛	𭣉
撟	挢
撠	𪮮
撧	𪮖
撳	揿
撴	撉
撶	𫼧
撸	擼
撽	𢶡
撾	挝
擁	拥
擃	𫼮
擈	𭠙
擉	𧣫
擏	𢠃
擓	𢭴
擔	担
據	据
擜	㩵
擞	擻
擢	𪟣
擥	㧛
擯	摈
擱	搁
擳	𰓜
擺	摆
擻	擞
擿	𢱦
攅	𬼼
攆	撵
攇	搟
攈	𢥄
攎	𢫘
攐	攓
攓	㩷
攔	拦
攕	㩥
攗	𢥐
攙	搀
攠	𣡂
攤	摊
攦	𰓬
攩	𫽮
攳	𰕁
攵	⺙
攺	𢻰
攻	𰏈
攽	𠚼
放	𰕆
政	𭤖
敃	𢼖
故	𬀇
敇	𭣯
敎	𤕝
敐	𢼧
敜	𫾿
敝	㡀
敠	敪
敡	𫾻
敩	斆
敫	𭤁
敭	𢾙
敿	敽
斅	𢽾
文	⽂
斈	𣁃
斉	⻫
斍	𣁐
斒	𣁊
斔	螤
斜	邪
斢	𪏡
斣	𣂌
斩	斬
斪	𣃖
斬	斩
斳	𣂷
斺	𣃘
旓	𰕩
旜	𭥆
旝	𰕭
旤	𠹬
旯	𡉆
旰	𣈨
旸	暘
旼	𪰋
昈	𥄅
昝	𭨚
昡	𣆂
昢	𣅽
昩	𠰌
昲	曊
昶	㫤
昷	𥁕
昽	曨
晈	𭦑
晌	㫾
晖	暉
晝	昼
晞	㬛
晠	𥆏
晤	𣅎
晦	𣎚
普	暜
晷	𠷳
晸	𪰱
暉	晖
暌	睽
暓	𣊃
暘	旸
暜	暜
暞	𣊊
暟	𬀱
暠	𣉞
暤	暭
暫	暂
暬	𣊓
暹	𨗴
曄	晔
曇	昙
曈	晍
曊	𪰶
曋	𣊢
曏	𬁠
曒	暞
曚	𣋡
曟	𨑌
曡	叠
曣	㬫
曤	𣉒
曨	昽
曪	𭿳
曫	𬁢
曭	𭧋
曮	𰖈
曰	⽈
曷	𭥭
朅	𩿹
朏	𣍧
朓	𰮥
朚	𦟁
朢	𬂒
朦	𬂓
末	𠅅
朹	𣏒
机	機
朻	𣎹
杆	桿
杈	肞
杌	柮
杏	𣒙
材	扐
杕	枤
杚	𣏙
杧	𣙷
杨	楊
杩	榪
杫	𣘩
東	东
杳	㫐
杴	㸝
杵	𥐭
杷	𣚒
杺	𨊳
板	闆
枖	𣓎
枘	𰊀
枚	𣏽
枡	桝
枢	樞
枧	梘
枨	棖
枰	檘
枲	䢄
枳	𣖌
枴	柺
柌	𣙼
柍	楧
柑	𤯃
柒	㭍
柞	𬃥
柟	𣏵
柣	𤙈
查	査
柫	柭
柬	𫠣
柮	𪲵
柶	𧣛
柷	拀
柹	𣐈
柽	檉
栃	𫞊
栐	柡
栛	𭪁
栝	桰
栟	栟
栩	𬄘
栮	𦕂
栯	㮋
栰	㭖
栳	硓
桒	桒
桔	䓀
桗	𣑫
桙	㭌
桚	㭮
桢	楨
档	檔
桤	榿
桧	檜
桪	樳
桫	𣘡
桭	栕
桱	𣐕
桵	㮃
桷	𢳇
桺	𫞉
梃	𬂹
梋	鋗
梌	㭸
梍	𣓛
梎	梎
梘	枧
梜	𬂩
條	条
梟	枭
梡	㯘
梥	𫁏
梪	𪲓
梫	𣖽
梬	𫀕
梱	𪲗
梵	𣑽
梶	捤
梼	檮
梾	棶
检	檢
棁	梲
棃	𫀺
棄	弃
棅	𭫗
棆	𰗖
棇	樬
棈	𰘍
棍	𪳡
棎	𣖒
棐	𩇹
棑	𣔉
棓	𢶶
棖	枨
棚	𬕔
棛	𣚥
棟	栋
棡	㭎
棪	𣝎
棯	菍
棲	栖
棷	𬃁
棸	𬃁
棼	𰅃
棿	𣕕
椃	𣘫
椏	𬂲
椑	𣔬
椚	𭩛
椛	𪲒
椝	槼
椠	槧
椤	欏
椫	樿
椮	槮
椯	𣖃
椱	𣘅
椲	㭏
椹	枮
椼	𰗿
楃	𣕋
楇	𣒌
楊	杨
楎	𰗢
楐	𬂣
楓	枫
楕	𬄭
楞	𪳏
楣	𢰲
楪	𭪱
楬	櫭
楮	𬄊
楴	𬃨
楶	㮞
榇	櫬
榈	櫚
榓	櫁
榔	𬃌
榣	榣
榤	𡏝
榩	𣖳
榪	杩
榬	𥰟
榯	𰗨
榺	𣚗
槏	𣓅
槖	𬃖
槚	檟
槧	椠
槨	𬃬
槩	㮣
槪	槪
槳	桨
槵	梙
槶	椢
槷	𣙗
槸	𣞕
槼	椝
槾	𪴂
樃	㮾
樉	𣜪
樑	𬃩
樗	櫖
標	标
樞	枢
樟	𭢓
樠	𣗊
樢	㭤
樣	样
樤	𣔌
樧	蔱
権	𫞐
樫	㭴
樮	𣗇
樲	𬃘
樳	桪
樴	𣖿
樻	𭫀
樼	𥢨
樿	椫
橀	𣕆
橁	槆
橅	𬂠
橇	䢪
橈	𣓤
橍	𣜝
橒	𢵆
橔	𧝋
橗	𦻽
橚	𰗹
橝	𣡣
機	机
橠	㰙
橥	櫫
橦	㮔
橪	㮒
橭	𣖥
橯	𣓿
橰	槔
橲	𭩳
橳	椦
橶	𣛔
橷	𣘛
檁	𬄜
檂	𬂰
檃	櫽
檄	𣜥
檈	𣞲
檒	𮨴
檔	档
檖	𣔾
檜	桧
檠	㯳
檤	𣜦
檥	𭩚
檨	檨
檭	𣘴
檲	𣑝
檳	槟
檴	㯉
檸	柠
檹	𣚂
檻	槛
檼	𬃡
櫃	柜
櫅	𪲎
櫎	𰗓
櫐	𰣟
櫒	𣘤
櫕	𣪁
櫙	藲
櫟	檪
櫠	𪲮
櫢	𰘸
櫨	籚
櫩	𰘠
櫯	𰘶
櫲	𣛿
櫴	𰘳
櫶	𬃫
櫷	𪳥
櫸	榉
櫹	𰘩
櫼	㰇
櫾	𣞿
欂	𣟔
欉	𬄿
欏	椤
欓	𣗋
欕	𣠨
欖	榄
欗	𬅉
欘	𣚚
欚	𣜡
欜	𣡪
欟	𣠤
欤	歟
欦	㰹
欧	歐
欬	𤸺
欭	𰙌
欵	𪴬
欶	𠲿
欷	𣣐
欹	𣣱
欻	歘
欽	钦
歂	𣤀
歄	𬅥
歆	𩐗
歈	𣤏
歉	䭑
歍	𰙋
歎	𣥁
歔	歔
歕	𬅫
歗	𰙑
歘	𣤛
歚	𬅬
歞	𪴯
歟	欤
止	⽌
歮	𬼫
歯	⻭
歳	歲
歴	厯
歺	⺞
殆	𫹸
殇	殤
殈	𮕞
殑	𣩦
殒	殞
殖	𰙽
殗	𣩯
殘	残
殟	殟
殢	𣨼
殤	殇
殥	𡒕
殨	㱮
殫	殚
殬	𣧃
殭	𣨣
殮	殮
殯	殡
毄	𬆦
毆	殴
毈	㱭
毋	⽏
毐	𡉓
毑	𣫰
毖	𪫠
毘	𭖵
毛	⽑
毟	挘
毠	𣭋
毣	𣭜
毱	𰚝
毷	𣯀
毸	𣯧
毽	𨪅
氁	𣯳
氃	𭯤
氉	𣰕
氋	𣰥
氌	氇
氛	雰
氝	氞
氨	𠼞
氩	氬
氫	氢
氭	𣱝
氮	㲷
氯	㲶
氰	𩇛
氵	⺡
氺	⺢
氻	𣱼
氽	𣵞
汃	𣱺
汅	𭂆
汊	㲼
汏	𣴒
汐	𣲠
汔	𣲁
汕	𭂈
汗	𣲇
汚	𣱴
汛	𣲌
汜	洍
汝	女
汤	湯
汧	汧
汭	𪞗
汱	𪵫
汴	𪵩
汷	泈
汸	淓
汿	沀
沂	𫥁
沆	𣳞
沉	㕴
沏	𭰀
沐	𬜃
沔	汅
沚	洔
沣	灃
沪	滬
沭	𣻚
沯	𣸐
沰	𣶦
油	𪸅
沽	𥂰
泆	浂
泊	淿
泍	𣳰
泔	粓
泝	𣳙
泠	澪
泣	𣲔
泧	𣳡
泯	冺
泱	𫥅
泻	瀉
洌	𣸟
洑	澓
洔	𣻞
洕	𣷩
洨	𣺳
洫	淢
洳	𣹤
洶	汹
洸	𣴕
洿	𣳹
浃	浹
浄	淨
浈	湞
浉	溮
浊	濁
浐	滻
浕	濜
浟	滺
浦	𠗒
浪	浪
浲	溄
浵	𣹊
浹	浃
浺	㳞
浻	㴄
浽	𩃃
浿	𬇙
涆	𣵼
涇	泾
涕	𬰐
涘	洠
涚	涗
涞	淶
涠	潿
涢	溳
涪	𣷧
涫	㴦
液	洂
涷	𰛒
涸	𤃯
涽	㬆
淆	殽
淌	灙
淒	𣷑
淓	𫈊
淕	㓐
淟	𠗘
淡	啖
淣	𣴼
淦	汵
淰	𣻧
淵	渊
淶	涞
淺	浅
渌	淥
渕	𰔂
渡	𣳥
渢	沨
渦	涡
測	测
渮	𣵣
渷	𣼠
渼	𨺰
渾	浑
湀	𣺍
湂	𣻵
湃	𪿪
湆	湇
湈	𣨴
湋	𣲗
湍	漙
湑	𣷢
湘	𪶛
湟	𣹛
湣	𣇹
湥	涋
湰	漋
湴	𡌶
湵	𦏇
溁	濚
溇	漊
溈	沩
溗	𣽘
溝	沟
溟	𬈑
溠	𤁺
溡	𪶄
溤	𰛊
溥	𣷼
溰	𰛥
溳	涢
滀	傗
滄	沧
滆	𣽐
滈	瀥
滊	𭰑
滎	荥
滙	𪶫
滛	滛
滜	𣽎
滠	灄
滢	瀅
滣	𪡤
滦	灤
滬	沪
滰	𬈣
滵	𣺑
滶	𣿗
滷	𰛮
滸	浒
滻	浐
滽	𣷈
滾	𪶦
漄	𬉍
漍	𬇹
漎	𰛏
漐	𰛣
漓	灕
漕	𤅍
漚	沤
漜	𡌯
漤	灠
漥	𪶙
漨	浲
漭	𣾘
漱	潄
漲	涨
漸	渐
漹	𬇵
漼	㵏
漿	浆
潁	颍
潆	瀠
潒	𣻍
潙	沩
潚	㴋
潠	𣹎
潪	𤁰
潫	𤂵
潬	𬈁
潰	溃
潲	𩛱
潷	滗
澁	渋
澅	𣶩
澇	涝
澈	𤁲
澒	𭱊
澔	𬈻
澖	𰛵
澗	涧
澚	𤀀
澛	瀂
澠	渑
澡	𰝂
澢	𭰎
澣	𣴟
澥	𣿨
澩	泶
澫	𬇕
澬	𫞚
澮	浍
澯	𫥚
澰	𰛲
澱	𣾮
澶	𭳧
澺	𣽢
澻	㴚
澽	𤁴
激	𰜹
濁	浊
濄	㳡
濏	𰜥
濚	溁
濜	浕
濠	𣻼
濤	涛
濥	𤃚
濦	𬈬
濧	㳔
濯	𡽢
濰	潍
濷	𬉞
濺	溅
濼	泺
濿	𪵱
瀂	澛
瀃	𣽷
瀇	㲿
瀈	𰝍
瀌	𤂏
瀔	濲
瀕	濒
瀗	𭂦
瀙	𰜜
瀠	潆
瀦	濖
瀧	泷
瀨	濑
瀩	𬉏
瀭	𬉦
瀯	𰝅
瀴	𰜳
瀸	瀐
瀾	澜
灃	沣
灆	𪷞
灇	𤀡
灉	㴩
灍	𫞝
灏	灝
灘	滩
灙	𣺼
灝	灏
灟	𭲫
灡	𬉠
灣	湾
灤	滦
灦	𰝤
灧	灩
灬	⺣
灱	灲
炄	𣅴
炊	𣣛
炔	𤆿
炛	𤆷
炝	熗
炟	𤉊
炥	𤇝
炲	𤊜
炴	𤈛
炸	煠
炻	𤇈
烐	𤆘
烔	燑
烕	𬆡
烙	烙
烠	𤏳
烡	𤈈
烥	𤇸
烦	煩
烩	燴
烴	烃
焏	𤊅
焖	燜
焘	燾
焜	熴
焞	𤑴
焧	𤊘
焩	𤊏
焫	𮀥
焯	𤎙
焲	焬
焵	焹
焸	焽
焻	𤈵
煍	𤋦
煒	炜
煔	熌
煝	𪾛
煣	𦔇
煥	焕
煨	燰
煫	𤋌
煬	炀
煱	㶽
煳	糊
煸	𫼯
熃	𤋄
熌	𤇄
熐	𤑺
熓	𤆡
熕	𬊎
熗	炝
熘	溜
熞	𰞤
熠	𦒉
熡	𤋏
熲	颎
熾	炽
燀	𬊤
燁	𤒫
燄	𬋓
燈	灯
燋	𤍫
燌	𰞻
燘	𬊖
燙	烫
燜	焖
燫	𤒄
燭	烛
燰	𬊺
燴	烩
燵	𬊉
燹	𤐨
燺	𪴍
燻	𤑛
燼	烬
燾	焘
爀	𤒋
爁	𬊶
爃	𫞡
爄	𤇃
爅	㷵
爉	𤎞
爋	𤑕
爌	𤆓
爏	㷴
爒	𬋘
爕	𪥢
爖	𤇭
爣	𬊵
爥	𪹳
爭	𣌦
爯	𭁣
爴	𦄰
爸	𤕕
牀	𪧇
牁	牱
牄	𩿄
版	㸞
牋	𰠛
牌	𤗋
牎	𪺥
牐	牐
牓	𤗒
牕	𪺠
牣	㸾
牤	𤛘
牫	𤘚
牭	㹑
牶	𢍕
牺	犧
牻	𤜆
牼	𰠲
犂	𪺳
犄	𰠸
犆	𢃜
犈	𤙻
犋	𰠱
犙	𤛤
犚	𤛌
犝	𤙓
犞	𪺭
犧	犠
犨	犫
犩	𤛲
犭	⺨
犳	𤜩
犸	獁
犺	𤞀
犻	𤜲
狁	𫧨
狃	𠒉
狄	翟
狇	𤝂
狈	狽
狌	𤯴
狔	𤝺
狙	𰡈
狚	𤞾
狛	𤝡
狟	𤞸
狡	𤟋
狣	𤞯
狦	𧲾
狪	𧳆
狰	猙
狲	猻
狴	𤡝
狶	㹷
狸	貍
狺	㹞
狽	狈
狿	𤜺
猋	𡘙
猌	𪺽
猖	𮛤
猙	狰
猤	𤢑
猯	𤟮
猲	𤢔
猵	獱
猷	䣭
猼	𧳵
獁	犸
獅	狮
獊	𪺷
獍	𧴈
獎	奖
獖	𰡞
獚	𤟡
獟	𬌮
獦	𤢠
獩	𤞃
獰	狞
獱	㺍
獳	𤡤
獶	獿
獹	𰡄
獺	獭
獼	猕
獿	𠑍
玀	猡
玁	𤞤
玂	𰡩
玃	𤣓
玒	玜
玖	㺵
玙	璵
玛	瑪
玞	砆
玡	琊
玥	玥
玦	𤤏
玨	𤤴
玪	砛
玮	瑋
玱	瑲
玴	𤤙
玻	𭹢
珀	砶
珁	𪼷
珐	琺
珑	瓏
珕	蛠
珗	𥑻
珙	㺬
珞	珞
珢	𤥛
珥	𥙟
珦	𤩬
珧	䖴
珩	𤤾
珬	㺷
珰	璫
珷	碔
珼	𫞥
珽	𫡘
現	现
琀	𤦜
琄	㻆
琈	姇
琍	𭹳
琏	璉
琔	𤩱
琠	𤩴
琤	碀
琥	𤦣
琧	𤦩
琩	𤦛
琪	𤦢
琯	璭
琲	㻗
琳	𭻜
琶	𤧲
琿	珲
瑂	𤩣
瑃	𤪪
瑈	瓇
瑉	𬁂
瑋	玮
瑌	𰢏
瑍	𤥺
瑒	玚
瑔	𪻼
瑕	瘕
瑞	𤨈
瑡	㺰
瑢	𪻽
瑣	琐
瑤	𰗕
瑨	𤨁
瑪	玛
瑯	𰢔
瑴	𫯁
瑷	璦
瑸	璸
瑹	𤨓
瑻	𪻲
瑾	𤪣
瑿	𤧧
璆	𥬃
璏	㻰
璑	𤤞
璕	𬍤
璖	𤥾
璙	𤪃
璛	𰢄
璝	𪻺
璢	𤩾
璣	玑
璦	瑷
璧	𤩹
璫	珰
璯	㻅
璲	𬰧
璷	琈
璸	瑸
璼	𫞨
璾	𫞦
瓄	𪻨
瓍	𤩼
瓏	珑
瓐	𰡵
瓑	𤪾
瓓	𬎑
瓕	𤦀
瓗	㼇
瓘	𭹾
瓙	𠩱
瓚	瓒
瓛	𤩽
瓟	𰢜
瓪	𤭍
瓯	甌
瓳	𤭱
瓻	𤭏
瓽	𦈹
瓿	䍌
甆	甆
甊	𰢦
甌	瓯
甎	𥶸
甓	𠙮
甔	𦉜
甕	𠂅
甖	𰢤
産	產
甤	甤
甥	㽒
甪	𫡒
甫	父
甬	𧗴
田	⽥
甽	𧈶
畊	𬏄
畍	𨺬
畑	畠
畓	𭻅
畔	沜
畗	𤲇
畤	𮥂
畨	𫂺
畩	𫞫
畷	𤲹
畸	𰣍
畹	㽜
畾	𤳏
畿	𤳀
疄	𤳩
疈	𫤊
疌	𤴗
疤	㿬
疫	𤶣
疭	瘲
疯	瘋
疴	痾
疶	𤵺
疷	𤵢
疹	𤺋
疽	𭼔
痀	𰀆
痄	𤶙
痆	𤷈
痉	痙
痋	𤼖
痎	㾬
痏	𢈓
痖	瘂
痗	𭓵
痠	𤷥
痣	䏯
痦	𤵐
痧	𤵌
痬	𤻂
痮	𪽪
痰	𭼍
痾	㢌
瘂	痖
瘃	𤷚
瘄	𰤄
瘇	𡰒
瘈	瘛
瘋	疯
瘍	疡
瘒	𬏫
瘓	痪
瘙	㿋
瘚	𤺤
瘛	𤺚
瘜	𦞜
瘡	疮
瘢	𤻧
瘧	疟
瘨	𤸘
瘫	癱
瘭	𤼄
瘮	瘆
瘲	疭
瘸	𠌳
癀	㾮
癉	瘅
癌	𤸔
癍	㿀
癎	𰣯
癐	𤶊
癑	𤼝
癒	𠏚
癔	𤴥
癖	䑀
癗	㿔
癟	瘪
癤	疖
癦	𦢓
癨	𭼲
癪	𰣼
癬	癣
癮	瘾
癯	𭼻
癰	𦡈
癱	瘫
癲	癫
癳	瘰
癿	𤼾
皈	𦤇
皌	𤽜
皔	𤽂
皚	皑
皜	𤾘
皟	𤾀
皡	𬛬
皢	𭽙
皦	曒
皸	皲
皽	𤿘
盆	瓫
盓	𥁡
盔	𨫿
盠	𥂻
盻	𥅎
眅	𥈼
眆	眪
眊	𥉗
眎	𦕝
眔	𥄳
眕	𥇐
眗	𥈈
眞	𠤤
眥	㫮
眩	眴
眬	矓
眭	𥍋
眴	䀏
眶	𩒑
眸	牟
眻	䁑
睁	睜
睅	䁔
睇	眱
睋	𬚚
睌	𥇅
睍	𪾢
睎	𥅹
睐	睞
睑	瞼
睗	𮌝
睙	𥈳
睛	𰥕
睜	睁
睧	𥄇
睬	倸
睸	𥋎
睹	覩
瞌	䐦
瞏	𤲡
瞐	𦋹
瞓	𰥛
瞗	𭧘
瞘	眍
瞛	𰥒
瞝	𣉽
瞡	𰥪
瞪	覴
瞱	𬑓
瞳	童
瞴	𥌇
瞵	𥌌
矀	𥋪
矃	眝
矈	𥌂
矍	𠑩
矎	𥌔
矐	𥉑
矑	𪾦
矒	𦢧
矕	𰥠
矗	𰅹
矘	𰥹
矚	瞩
矯	矫
矱	𫊆
矲	𰦜
矴	碠
矶	磯
矽	釸
码	碼
砅	濿
砍	𣢈
砒	磇
砜	碸
砝	䂲
砢	𥗴
砦	𥓽
砧	碪
砪	𬒐
砬	磖
砯	𭇛
砲	𥔰
砸	𢹼
砹	銰
硅	𥓩
硈	𥑄
硍	𥓀
硐	硧
硕	碩
硖	硤
硘	𬒅
硙	磑
硚	礄
硜	硁
硡	𥐪
硣	𥕪
硤	硖
硩	𥓊
硪	𨁟
硭	𥒴
硯	砚
硵	磠
硻	𥑒
硽	𪿬
碊	𥒎
碏	𰧦
碐	𰦽
碓	𫄻
碔	𥕻
碖	磮
碙	𥐻
碛	磧
碡	𥖠
碢	𰦿
碩	硕
碭	砀
碯	𥔥
碴	𦉆
碶	𬑻
碸	砜
確	确
碼	码
碽	䂵
磀	𥑺
磂	𰧡
磃	𥓚
磅	𥓯
磉	𰧨
磑	硙
磒	𬒍
磓	𥑵
磘	𥕬
磙	𥕦
磚	砖
磜	𮀔
磠	硵
磡	𥓒
磣	碜
磪	𡽛
磱	𮀤
磳	𰧞
磵	𰧃
磶	𥖽
磹	𥐯
磾	䃅
礁	嶕
礄	硚
礆	硷
礈	𪿯
礉	䃝
礊	𥖳
礏	𬒆
礓	𥗪
礗	𥖶
礙	碍
礜	𪿝
礝	𥕷
礟	𮁘
礣	𥗥
礤	礸
礥	𰧇
礮	𪿫
礰	𰦦
礱	砻
礲	𰦭
礸	𰧪
礹	𰦾
礻	⺭
祇	秖
祎	禕
祠	𰨤
祡	𥚨
祣	𥜠
祦	禑
祯	禎
禁	𣔋
禃	𫌁
禊	稧
禔	䃽
禕	祎
禚	𫌉
禠	𥛕
禡	祃
禦	御
禬	𰧻
禯	𰧾
禲	𥜍
禳	𮂜
禶	𮂠
禷	𥜛
禺	𤟹
禾	⽲
秈	𦱑
秊	秊
秌	𤇕
秐	𥢚
秖	秪
秛	𫀲
秜	𥞭
租	𥠙
秡	𮂺
秩	豒
秬	𩰤
秹	𬓧
秺	䅊
秾	穠
稏	䅉
稐	耣
稒	㧽
稓	𨞒
稔	䄒
稤	䅫
稩	𥡏
稭	𥚺
稰	𥟮
稶	稢
稹	槙
穉	𥣡
穋	𥢩
穌	稣
積	积
穏	穏
穖	𬓠
穛	𥼚
穞	穭
穠	秾
穢	秽
穨	𬓼
穩	稳
穭	𮬀
穱	𥤏
窀	𥤭
窋	𡧨
窘	僒
窨	堷
窩	窝
窮	穷
窯	𰍔
窲	𥧇
窴	𥧑
窵	窎
窶	窭
窸	𭔎
窺	窥
窼	𭔐
竂	𰩐
竅	窍
竇	窦
竉	𰩅
竌	𥩕
竎	𮄧
竘	𥩞
站	𥩠
竜	⻯
竝	𭤳
竣	𥪣
竧	䠴
竰	𥩘
竱	𫁟
竲	𥫁
竺	笁
竽	𥫡
笄	筓
笆	䈈
笇	𥳪
笈	𥭊
笓	𦊁
笕	筧
笙	𤯛
笠	笠
符	𮅟
笭	䉖
笯	𥲘
笰	𩉽
笲	匥
笴	𥯽
笵	𫈣
笸	箥
笿	𥯛
筀	𥯫
筄	𥬻
筆	笔
筇	笻
筒	筩
筜	簹
筟	𬖇
筠	𮅀
筡	𥱻
筦	𥭨
筧	笕
筪	笚
筭	𰱂
筳	𮞺
筴	䇲
筶	𥭅
筿	篠
箂	筙
箇	𮈗
箏	筝
箝	𥮠
箠	𥴓
箣	𥰍
箩	籮
箳	簈
箶	𥬏
箽	𥳘
篍	𥰂
篐	𣙖
篓	簍
篔	筼
篞	𥭧
篢	𬕂
篤	笃
篩	筛
篯	籛
篰	𥰵
篴	𨗹
篵	𥬈
篻	𥲦
篼	𮅷
簀	箦
簁	𥳧
簂	𫂆
簅	𦸰
簇	蔟
簌	𬝜
簍	篓
簎	𥶪
簏	盝
簖	籪
簙	𥴮
簝	𥵐
簥	𰩸
簳	𥶭
簵	𰪏
簷	𥶕
簹	筜
簽	签
簿	篰
籁	籟
籃	篮
籅	𥰩
籉	𥱆
籌	筹
籕	𰪡
籚	𰩲
籛	篯
籜	箨
籟	籁
籤	𬕵
籦	𰪊
籪	簖
籭	𬕄
籱	籗
籷	𪐏
籹	𥹡
粄	𥽴
粑	𩚥
粔	𪌖
粕	𨠘
粯	𬖑
粰	𥼄
粵	𦉿
粶	𥼙
粸	𪍀
粻	𰪭
粿	𥼑
糅	粈
糆	𥻩
糙	㿷
糝	糁
糪	𥽷
糰	𰪶
糲	粝
糽	𰫼
紂	纣
約	约
紅	红
紆	纡
紈	纨
紉	纫
紋	纹
紌	𬘕
紑	𰫽
紒	𰬀
紓	纾
純	纯
紕	纰
紗	纱
級	级
紛	纷
紜	纭
紝	纴
紡	纺
紩	𮉢
紭	𰬋
細	细
紱	绂
紲	绁
紳	绅
紶	𬘛
紸	𰬇
紼	绋
紽	𰬉
絀	绌
絁	𫄟
絃	𰬈
組	组
絆	绊
絍	𫟃
絎	绗
絑	𰬏
絖	𬘢
絘	𰬒
絚	𰬌
絜	𮈑
絝	绔
絟	𬘥
絠	𬘠
絡	络
絤	𬘟
給	给
絧	𫄡
絨	绒
絪	𬘡
絯	𰬓
絰	绖
統	统
絳	绛
絶	絕
絸	𬘖
絺	𫄨
絼	𰬛
絽	𬘤
絾	𰬖
絿	𰬗
綀	𦈌
綁	绑
綃	绡
綆	绠
綇	𦈋
綈	绨
綉	绣
綊	𰬍
綋	𫟄
綍	𰬘
綏	绥
綐	䌼
綔	𦁝
綕	𬘨
綖	𫄧
綗	𦀝
綜	综
綝	𬘭
綞	缍
綢	绸
綣	绻
綧	𬘯
綪	𬘬
綫	线
綰	绾
綳	绷
綴	缀
綸	纶
綹	绺
綺	绮
綻	绽
綼	𰬤
綿	绵
緂	𰬧
緊	紧
緋	绯
緍	𦈏
総	𰬥
緐	𥿋
緔	绱
緗	缃
緘	缄
緙	缂
線	缐
緛	𬘰
緝	缉
緞	缎
締	缔
緢	𰬬
緣	缘
編	编
緩	缓
緪	絙
緫	𰬰
緬	缅
緯	纬
緰	𦈕
緱	缑
緲	缈
緶	缏
緸	𦈑
緹	缇
緺	𮉨
緻	𰬫
緽	𬗨
縀	𦀩
縂	縂
縈	萦
縉	缙
縊	缢
縋	缒
縍	𫄰
縎	𦈔
縓	𰬲
縖	𬘻
縗	缞
縛	缚
縜	𰬚
縝	缜
縞	缟
縟	缛
縧	绦
縪	𰬎
縫	缝
縭	缡
縯	𬙂
縲	缧
縵	缦
縶	𦅬
縸	𫄲
績	绩
繀	𮉮
繄	𧫦
繅	缫
繆	缪
繎	𬙇
繒	缯
織	织
繕	缮
繖	𰬷
繗	𬙈
繙	𬙆
繚	缭
繜	𰬺
繞	绕
繟	𦈎
繢	缋
繣	𰬠
繨	𫄤
繬	𫄱
繮	缰
繯	缳
繰	缲
繲	𰬽
繳	缴
繵	𬙉
繷	𫄣
繽	缤
繾	缱
繿	䍀
纀	𰬿
纄	蘕
纇	颣
纈	缬
纋	𰭀
纍	累
纕	𬙋
纜	缆
纞	𦃳
红	紅
纨	紈
纬	緯
纮	紘
纹	紋
纺	紡
纻	紵
绀	紺
绌	絀
绐	紿
给	給
绞	絞
绢	絹
绨	綈
绪	緒
绬	緓
维	維
绶	綬
绺	綹
绻	綣
综	綜
缂	緙
缃	緗
缈	緲
缍	綞
缔	締
编	編
缗	緡
缛	縟
缟	縞
缢	縊
缣	縑
缪	繆
缬	纈
缻	𬎩
缿	銗
罃	䓨
罉	𦉘
罌	罂
罓	⺱
罜	𦊝
罫	𥦛
罯	𦋫
罰	罚
罳	𦋮
罴	羆
罷	罢
罿	𦌜
羂	𰭔
羃	𥵵
羈	羁
羖	𦍩
羗	𥱑
羜	𬙯
羢	𬙱
羥	羟
羴	𫅓
羵	𫅗
翁	𪂔
翇	𦐗
翋	𦒆
翍	𦐢
翐	𦐝
翑	𦐛
翛	𦐻
翜	𰭢
翡	𫅪
翨	𦑧
翬	翚
翯	𩫉
翵	𪄊
翹	翘
翺	翺
翽	翙
翿	𰭣
耂	⺹
耍	𫰗
耚	𤱍
耝	刞
耞	𥝿
耡	耝
耣	𦓾
耩	𥠾
耮	耢
耰	櫌
耳	⽿
耾	𦕹
聁	𬚔
聂	聶
聇	眐
聎	𦖅
聝	𢦛
聞	闻
聠	聠
聣	𬚠
聤	𤸥
聥	𦞇
聳	耸
聴	𥌩
聶	聂
聹	聍
肀	⺺
肂	𦘖
肑	𥭖
肖	俏
肘	䏔
肜	𭛓
肝	𭨩
肪	𩨣
肮	骯
肶	䃾
肷	膁
肿	腫
胆	膽
胍	𬁾
胑	𩨵
胘	𦘷
胞	𦚽
胣	肔
胦	暎
胧	朧
胨	腖
胰	𦚟
胲	𮌑
胵	𦙆
胶	膠
胷	𩌠
胻	䯒
胼	腁
脅	胁
脈	脉
脖	𩓐
脗	𮋱
脜	䐓
脞	𢏬
脟	𦛷
脠	𦚺
脥	𣍰
脬	泡
脰	𦣓
脵	𫞆
脹	胀
腅	𩩧
腋	掖
腎	肾
腏	𪠰
腑	府
腖	胨
腠	傶
腡	脶
腢	髃
腣	䐭
腤	𦝡
腧	俞
腨	𨄔
腪	𣍯
腫	肿
腸	肠
腹	𦞶
腽	膃
膇	𨃬
膈	䐙
膌	𦢕
膑	臏
膓	𮌷
膙	𢐩
膚	肤
膟	𦝭
膡	䒅
膨	𤺬
膮	𰮝
膯	𦡪
膱	𥋏
膳	饍
膶	𬂀
膷	𰮅
膽	胆
臃	𦡚
臆	肊
臈	﨟
臉	脸
臖	𦢰
臚	胪
臞	𦣒
臬	槷
臯	𦤑
臽	𦥢
舓	𦧑
舖	舗
舘	舘
舚	𦧻
舝	𭷤
舠	𦩍
舦	𦨐
舫	𰓞
舰	艦
艁	㬶
艂	𦪎
艄	梢
艌	𤽿
艏	𦩽
艓	𮎉
艕	𦪤
艙	舱
艛	𰰑
艜	𰰏
艝	轌
艟	衝
艣	𫇛
艦	舰
艨	蒙
艭	𰰋
艴	𦫛
艷	艳
艻	𦬋
艿	𦮘
芀	䒒
芊	谸
芎	𦵡
芗	薌
芙	𫈌
芛	𦭽
芜	蕪
芡	𫈀
芩	𫇧
芭	𮎣
芳	芳
芴	𦲇
芵	𦯊
芷	𦭒
芾	𦬝
苁	蓯
苅	𫟌
苈	藶
苋	莧
苌	萇
苎	苧
苓	䕘
苛	𰳖
苡	𫈄
苢	苡
苨	䕥
苫	𦺭
苮	𦭗
苳	𦵝
苹	蘋
茄	𫈠
茈	𦶉
茋	𦰘
茏	蘢
茓	踅
茔	塋
茛	𫈇
茣	茣
茩	𪲉
茮	𦯝
茯	𬜠
茷	笩
茺	𦯇
茻	𦬠
荃	𦼂
荇	莕
荈	𦯢
荊	𬏄
荚	莢
荝	萴
荟	薈
荥	滎
荦	犖
荬	蕒
荰	𫇾
荴	𦰂
荺	𦮢
荼	𦹍
莇	荕
莉	菞
莑	𦮧
莒	𰪠
莕	𫈗
莜	𦰞
莠	𦽧
莢	荚
莦	𦷟
莧	苋
莩	苻
莪	䕏
莬	𮫝
莭	莭
莯	𦱈
莲	蓮
莴	萵
莶	薟
莸	蕕
莿	𬜱
菅	𦭂
菇	菰
菋	苿
菏	𦶒
菒	𮏦
菕	𰰨
菖	昌
菞	𦴙
菤	𦶘
菨	𦯺
菪	𦿆
菬	𦻟
菰	苽
菲	𦻥
菻	𦱍
菾	𦲑
萇	苌
萋	緀
萒	𦳆
萚	蘀
萝	蘿
萨	薩
萯	𰰷
萴	荝
萵	莴
萷	蕱
萺	𦽹
萾	𦰆
葂	莬
葇	𦺤
葊	𦷼
葒	荭
葖	𦴯
葢	𪨻
葤	荮
葦	苇
葧	𦸦
葯	药
葳	𭺶
葷	荤
葸	𦷚
葻	𬜥
葿	𦼻
蒀	蒕
蒄	𦵤
蒇	蕆
蒌	蔞
蒏	醟
蒒	𰰳
蒓	莼
蒕	𥠺
蒘	𦬻
蒟	𦵑
蒤	𭱻
蒦	彠
蒪	𦾕
蒭	𫇴
蒲	𮑱
蒳	𰱌
蒵	𦷲
蒶	𰱍
蒻	𦭲
蒼	苍
蓀	荪
蓁	𦴼
蓃	𦲪
蓇	𬟟
蓈	𮑛
蓊	𩮬
蓌	䟶
蓐	𦸳
蓛	𦵪
蓠	蘺
蓣	蕷
蓦	驀
蓯	苁
蓰	𫈾
蓵	𦻴
蓻	𫈐
蓽	荜
蓾	𦷕
蔀	𩅇
蔄	𬜬
蔈	𧄖
蔋	𦵦
蔌	䔩
蔎	𰰺
蔓	𦽦
蔖	蔖
蔚	𦵥
蔞	蒌
蔠	𰱛
蔢	𪳪
蔣	蒋
蔦	茑
蔫	𣩙
蔭	荫
蔮	𬜿
蔯	𫈟
蔱	𰰵
蔴	𫉭
蕄	𰱉
蕆	蒇
蕇	𧂳
蕉	𤍳
蕎	荞
蕏	藸
蕑	𰱇
蕒	荬
蕓	芸
蕖	蘧
蕘	荛
蕛	𧀾
蕞	𦸤
蕟	𬜧
蕧	𰱦
蕩	荡
蕮	𧂙
蕰	薀
蕷	蓣
蕸	𫉽
蕹	䔨
蕼	𧀳
蕾	瓃
薁	𦼣
薆	𫉁
薈	荟
薉	𬜨
薊	蓟
薋	𰱱
薌	芗
薘	荙
薙	𦿶
薚	𧀫
薟	莶
薠	𮐚
薡	𦽍
薨	𣩾
薪	𣃄
薬	𣛙
薱	𰰱
薸	䕯
薺	荠
薻	𧁍
薾	𦬼
薿	𥣖
藀	𦳖
藄	𦸀
藆	𧃕
藒	𦿋
藓	蘚
藔	𦾍
藖	𬜾
藘	𰱮
藩	籓
藪	薮
藬	𬞘
藰	𰰹
藴	蘊
藷	𫉄
藼	𦶴
藽	𧅜
藿	𧆑
蘂	𦲜
蘄	蕲
蘈	𰲁
蘊	蕴
蘏	蘔
蘐	𬣊
蘑	𧀋
蘒	蘒
蘙	𰱺
蘚	藓
蘛	𧃠
蘜	蓻
蘞	蔹
蘟	𦻕
蘠	𮒙
蘡	𮐨
蘢	茏
蘥	𦿈
蘩	𦾴
蘪	𧃧
蘱	𰲒
蘷	𧃰
蘸	𧀡
蘹	𬜸
蘼	蘪
虅	𰲂
虇	𮆦
虈	䖀
虗	𧆳
虮	蟣
虴	𧎩
虶	𧈯
虻	蝱
蚅	𧉵
蚋	蜹
蚗	𧊍
蚝	蠔
蚞	𧉱
蚧	𧎁
蚯	𫋄
蚰	𧏿
蚱	𧉹
蚶	魽
蚹	𧊆
蚼	𧊛
蚾	𪓜
蚿	蛝
蛉	𧕅
蛏	蟶
蛕	𫋒
蛖	𧊑
蛡	𫊼
蛢	蛢
蛧	𧈿
蛪	𧑨
蛱	蛺
蛸	鮹
蛹	𧍛
蛺	蛱
蛻	蜕
蛼	𰲬
蛽	𬹠
蛿	𬠑
蜀	𦉶
蜆	蚬
蜍	𬹡
蜑	䗺
蜓	𮔖
蜔	𮓿
蜕	蛻
蜞	蜝
蜠	𧶞
蜢	𰳙
蜦	𰲰
蜩	𧊓
蜳	𧔫
蜵	𬠔
蜸	𰲮
蜻	𧓔
蜼	𧳫
蜽	𮔊
蝀	𬟽
蝁	𰲸
蝂	𧌿
蝄	𧍑
蝈	蟈
蝌	𧎗
蝍	𧑂
蝕	蚀
蝘	𧓱
蝜	𮔅
蝡	𧔀
蝭	𧍝
蝮	𧐛
蝵	𧎐
蝸	蜗
蝼	螻
蝾	蠑
螄	蛳
螈	䖠
螊	𧍧
螋	䗏
螌	𧏘
螏	𧎿
螗	唐
螘	𰲹
螛	𧕱
螞	蚂
螟	𧒳
螢	萤
螨	蟎
螰	𧐳
螲	𧍱
螴	𰳄
螸	𧐄
螻	蝼
螿	螀
蟈	蝈
蟋	𧒓
蟔	𫜞
蟖	蟴
蟙	𧊄
蟛	蟚
蟜	𫊸
蟟	蟧
蟥	𧓛
蟧	𮔚
蟨	蟩
蟪	𬹢
蟫	𧖋
蟬	蝉
蟭	𧖝
蟯	蛲
蟳	𫊻
蟺	𫢀
蟿	𧒼
蠀	𧏗
蠃	𧕳
蠅	蝇
蠊	𧒲
蠏	𧒻
蠑	蝾
蠒	𫊱
蠓	𰲽
蠔	𧐢
蠛	䘊
蠞	𬝋
蠠	𧕵
蠦	𫊮
蠩	鯺
蠪	𰲴
蠭	𧔧
蠯	𢌆
蠰	𧐀
蠱	蛊
蠳	𰳗
蠶	蚕
蠻	蛮
蠼	蠷
蠽	𧕾
蠿	𧖀
衃	𧖯
衏	𢕋
衒	𧗳
衖	𢕁
衙	𧗮
衞	𭲸
衠	衠
衤	⻂
衦	𥾍
衪	𧛖
衯	𧘠
衱	𥘜
衴	𧙇
衸	𧘷
衺	𮖊
衿	紟
袂	䘧
袆	褘
袊	𧟙
袎	𥿌
袗	𥘼
袘	衪
袚	𧙂
袛	𰏆
袞	𧚹
袣	𧙟
袥	𧘐
袯	襏
袱	幞
袲	袳
袷	衱
袻	𮁮
裄	𮁴
裆	襠
裈	褌
裉	褃
裊	袅
裎	𫢃
裗	裗
裝	装
裞	裞
裠	𬡝
裢	褳
裮	𢃑
裱	褾
裲	𮖁
裳	𫵅
裴	裵
裷	𧙯
製	𧚳
裾	𥚑
褂	袿
褉	𬡈
褊	𥚹
褍	𧞖
褎	𮕻
褓	緥
褛	褸
褡	𧝡
褢	𧙪
褬	𥛋
褯	𧞝
褲	裤
褸	褛
襇	裥
襈	𧛴
襌	褝
襏	袯
襒	𧝬
襓	𫋹
襗	𫋷
襘	𫋻
襚	𧞸
襝	裣
襞	𧞃
襠	裆
襨	𰳸
襪	袜
襫	𧞲
襭	𮖱
襯	衬
襰	𧝝
襲	袭
襵	𫌇
襷	𧜎
襸	𬡷
襹	𰳼
襾	覀
覂	𢇫
覎	觃
規	规
覓	觅
覙	𫌨
覜	𬢋
覟	𬢌
覠	𰴙
覡	觋
覢	𬊦
覤	𬟪
覥	觍
覦	觎
覩	𬢎
覬	觊
覮	䁝
覯	觏
覰	𰴜
覲	觐
覴	𬢔
覶	𰴝
覷	觑
覸	𰴘
覻	𰴞
觊	覬
觋	覡
觎	覦
觔	𧣊
觠	𩓫
觪	𧣿
觫	𧥆
觸	触
訁	讠
訂	订
訃	讣
訅	𬢟
訆	𰵊
計	计
訌	讧
討	讨
訐	讦
訒	讱
訕	讪
訖	讫
記	记
訛	讹
訜	𫍛
訝	讶
訣	诀
訥	讷
訦	𰵒
訨	𫟞
訪	访
訬	𰵏
設	设
訴	诉
訶	诃
訸	𰵝
診	诊
註	𬣣
詁	诂
詂	𧨽
詃	𬣤
詇	𰵗
詊	𫟟
詌	𬣠
詎	讵
詏	𬣦
詒	诒
詓	𫍜
詔	诏
評	评
詖	诐
詗	诇
詘	诎
詛	诅
詜	𬣥
詝	𬣞
詞	词
詠	𰵞
詡	诩
詢	询
詣	诣
詥	𰵣
試	试
詧	𧦴
詫	诧
詬	诟
詭	诡
詮	诠
詰	诘
話	话
該	该
詳	详
詴	𬣩
詵	诜
詶	𬣱
詷	𫍣
詺	𬣮
詻	𰵤
詼	诙
詽	訮
詿	诖
誁	𬣲
誄	诔
誅	诛
誆	诓
誊	謄
誋	𫍪
認	认
誏	𬣼
誐	𰵮
誒	诶
誔	𬣻
誕	诞
誗	𰵭
誙	𰵡
誚	诮
誜	𰵯
語	语
誡	诫
誣	诬
誤	误
誧	𰵩
誨	诲
誩	𧮣
誫	𫍨
誰	谁
課	课
誴	𫟡
誶	谇
誹	诽
誼	谊
諀	𧨬
諁	𰵷
諂	谄
諃	𰵱
談	谈
諉	诿
諌	㖦
諍	诤
諏	诹
諐	𬿏
諑	诼
諔	𰵴
諗	谂
諛	谀
諜	谍
諞	谝
諢	诨
諤	谔
諦	谛
諧	谐
諯	𫍱
諱	讳
諲	𬤇
諳	谙
諴	𫍯
諶	谌
諷	讽
諺	谚
諼	谖
謀	谋
謂	谓
謅	诌
謆	𫍸
謊	谎
謋	𰵼
謍	𰴯
謎	谜
謐	谧
謓	𬢻
謔	谑
謕	𧪥
謖	谡
謗	谤
謙	谦
謚	谥
謜	𰵺
謝	谢
謞	𰵿
謠	𬷠
謥	𰶂
謧	𧮛
謫	谪
謯	𫍹
謵	𰶃
謸	𫍵
謺	𧬓
謾	谩
譂	𫟠
譄	𬤤
譆	𫍻
譈	𬤣
譊	𫍢
譌	𰵑
譎	谲
譏	讥
譐	𬤢
譑	𫍤
譒	𬢸
譗	𬢿
譚	谭
譟	𬤨
譠	𰶉
譡	𬣭
譨	𫍦
譩	𰶊
譫	谵
譬	𨐫
議	议
譱	𧨅
譹	𬤫
譻	𬢯
譼	䛓
譾	𫍿
譿	𬤭
讄	𧬀
讇	𬤛
讈	𧬎
讉	𬤦
讋	詟
讒	谗
讕	谰
讖	谶
讛	𰵖
讞	谳
讟	𮙋
认	認
讦	訐
讧	訌
讬	託
讴	謳
讵	詎
诂	詁
评	評
诏	詔
诓	誆
试	試
诘	詰
诙	詼
诚	誠
诜	詵
诠	詮
诣	詣
诤	諍
该	該
诮	誚
诵	誦
请	請
诼	諑
诽	誹
课	課
诿	諉
谁	誰
谂	諗
谅	諒
谈	談
谉	讅
谌	諶
谏	諫
谒	謁
谕	諭
谖	諼
谘	諮
谡	謖
谬	謬
谴	譴
谾	𩓅
豄	𰶔
豊	𧯽
豎	竖
豑	𧰅
豙	𧱏
豝	𤜱
豞	𧰴
豟	𤝤
豠	𧱑
豥	𧱱
豬	𢑳
豭	猳
豮	豶
豾	𤞜
貃	𬐏
貇	𧳢
貍	𧴔
貓	猫
貗	𫎌
貛	貆
貜	𬥅
貟	贠
負	负
財	财
貣	𰷞
貦	𰷡
貧	贫
貨	货
販	贩
貪	贪
貫	贯
責	责
貱	𬥶
貴	贵
貶	贬
貸	贷
費	费
貼	贴
貿	贸
賀	贺
賃	赁
賄	贿
賅	赅
賊	贼
賍	赃
賑	赈
賒	赊
賔	𢊟
賕	赇
賗	𬥸
賙	赒
賛	𰷣
賜	赐
賝	𫎩
賞	赏
賟	𧹖
賠	赔
賡	赓
賥	𰷤
賦	赋
賧	赕
賨	𰷥
賫	赍
賬	账
賭	赌
賮	𰷧
賯	𧵣
賶	𬥳
賹	𰷪
賺	赚
賻	赙
賽	赛
贂	𬥞
贃	𧹗
贄	贽
贅	赘
贉	𫎫
贋	赝
贍	赡
贑	𫎬
贒	𦣶
贚	𫎦
贛	赣
贠	貟
贡	貢
贲	賁
贴	貼
费	費
贺	賀
赀	貲
赁	賃
赇	賕
赑	贔
赒	賙
赕	賧
赙	賻
赵	趙
赽	𧻯
超	𧺚
趏	𬦐
趓	𧻞
趖	𧼻
趗	𮚼
趛	赺
趞	𧾀
趢	𧼢
趥	䠓
趩	𨅜
趬	𰷵
趰	趂
趲	趱
趶	𧿉
趸	躉
跁	𧿏
跃	躍
跌	𮜆
跎	𧿶
跐	𧿿
跑	𨀓
跖	𨀂
跘	𨀷
跞	躒
跠	𡱐
跡	迹
跤	交
跫	𧿖
跰	跰
跲	𨕽
跶	躂
跺	跥
跼	𨄙
跿	𨃝
踁	𨀃
踆	𰸓
踈	𣦚
踉	𨄂
踐	践
踒	𨄖
踕	𨄀
踚	𬦧
踝	腂
踢	𰸄
踤	𧺒
踦	㞆
踮	跕
踯	躑
踸	𧿒
踹	𫏧
踻	𨀩
蹌	跄
蹐	𨇋
蹔	𫏐
蹕	跸
蹚	𨅨
蹛	𰸚
蹟	𫏏
蹣	蹒
蹥	𰸔
蹩	䠥
蹭	𭣃
蹸	𨆴
蹼	𨆯
蹿	躥
躀	𬦻
躃	𰙮
躊	踌
躍	跃
躎	䟢
躐	𨆍
躑	踯
躒	跞
躓	踬
躗	躛
躚	跹
躡	蹑
躢	𨇡
躣	忂
躥	蹿
躦	躜
躨	𨈉
躩	𨈍
躬	躳
躳	𨈴
躴	𨉰
躿	𨈢
軀	躯
軉	𨉗
軋	轧
軍	军
軕	𫐅
軙	𬧵
軜	𫐇
軞	𬨁
軟	软
軤	轷
軥	𰺁
軩	𨊺
軮	𬨄
軯	𰹽
軱	𮝴
軲	轱
軷	𫐈
軸	轴
軹	轵
軻	轲
軼	轶
軾	轼
輁	𰺄
輂	𰺅
輄	𨐈
輅	辂
輇	辁
輋	𪨶
輍	𨌯
輐	𰺇
輑	𰺈
輒	辄
輔	辅
輖	𫐏
輙	𰺋
輚	𰹼
輟	辍
輤	𰺉
輥	辊
輩	辈
輫	𰺎
輯	辑
輰	𠤓
輱	𰹓
輲	𰺒
輳	辏
輵	𬨍
輾	辗
轄	辖
轅	辕
轆	辘
轇	𫐖
轍	辙
轎	轿
轏	𰺞
轐	𫐗
轑	𰺛
轔	辚
轝	𬛼
轧	軋
轪	軑
轮	輪
轱	軲
轲	軻
轵	軹
轶	軼
轷	軤
轺	軺
轼	軾
辀	輈
辁	輇
辆	輛
辌	輬
辏	輳
辒	輼
辕	轅
辠	𤽮
辮	辫
迊	𬅹
迋	𨑳
迌	𬦈
迍	𨑞
迒	䢚
返	𢓉
这	這
迭	𨒔
迲	𬅻
迳	逕
迻	𡖰
追	𠂤
逅	𨒙
這	这
逛	𢚯
逝	𮞝
逨	𰻎
逪	𨗀
逫	䟾
逯	𨓻
逻	邏
逼	偪
逽	𨔏
遈	𨕒
過	过
遙	遥
遢	𧰂
遤	𫹞
遨	𨗯
遪	𨗘
遫	𨔤
遯	𦟥
遱	𫐷
遳	𦹇
遺	遗
邁	迈
邆	𨗱
邌	𨘯
邎	𨙂
邓	鄧
邘	𨙱
邝	鄺
邠	𨚇
邨	𨙲
邯	𨚠
邲	𨸼
邵	𰏏
邶	鄁
邺	鄴
邽	郌
郈	𨚨
郏	郟
郓	鄆
郖	𨜹
郗	𰻪
郚	䦜
郝	𨹮
郟	郏
郠	𨜦
郡	𨛦
郢	𨙼
郱	郱
郲	𬩾
郴	𬈥
郵	邮
郹	𨜯
郺	𡗌
郼	𨜢
鄀	𦂍
鄄	𨞉
鄆	郓
鄇	𨜫
鄍	𨝊
鄎	息
鄒	邹
鄔	邬
鄕	𨝅
鄛	鄛
鄞	𮠆
鄤	𨞼
鄫	𰻹
鄯	𨟪
鄲	郸
鄶	郐
鄺	邝
鄼	酂
酁	𨞭
酅	𨟎
酇	鄼
酌	𭅌
配	𮠟
酑	𨠱
酓	𨟹
酠	𧟫
酡	𨠑
酮	𨣒
酴	𨢬
醁	𮠮
醆	𬪨
醋	𨣋
醚	𨡅
醠	𨠗
醦	𮠳
醧	𬪧
醭	𢴁
醴	醴
醹	𨢾
釃	酾
釅	酽
釓	钆
釔	钇
釕	钌
釘	钉
釙	钋
針	针
釞	𨤿
釟	𫓥
釣	钓
釤	钐
釥	𰽛
釦	𬬪
釧	钏
釨	𫓦
釩	钒
釪	𰽗
釬	𬬧
釰	釼
釲	𫟳
釷	钍
釹	钕
釺	钎
釽	𬬲
釾	䥺
鈀	钯
鈁	钫
鈄	钭
鈆	𫓪
鈇	𫓧
鈈	钚
鈉	钠
鈋	𨱂
鈍	钝
鈎	钩
鈏	𰽣
鈐	钤
鈑	钣
鈒	钑
鈓	𬬯
鈔	钞
鈖	𫟴
鈛	𫓨
鈜	𮣳
鈞	钧
鈣	钙
鈤	𰽡
鈥	钬
鈦	钛
鈧	钪
鈨	鎺
鈪	𰽞
鈭	𨦠
鈮	铌
鈯	𨱄
鈰	铈
鈲	𨱃
鈳	钶
鈴	铃
鈵	𰽥
鈶	𬭀
鈷	钴
鈹	铍
鈼	𬬽
鈽	钸
鈾	铀
鈿	钿
鉀	钾
鉁	𨱅
鉅	钜
鉈	铊
鉉	铉
鉊	𬬿
鉌	𰽬
鉍	铋
鉏	𬬺
鉐	𬬷
鉑	铂
鉕	钷
鉗	钳
鉘	𰽱
鉙	𰽨
鉚	铆
鉛	铅
鉜	𰽮
鉝	𫟷
鉞	钺
鉟	𰽧
鉠	𫓭
鉡	𰽰
鉢	钵
鉤	𰽭
鉦	钲
鉧	𬭁
鉨	鿭
鉬	钼
鉭	钽
鉮	𬬹
鉲	𰽩
鉷	𫟹
鉸	铰
鉺	铒
鉻	铬
鉽	𫟸
鉿	铪
銀	银
銁	𫓲
銂	𫟻
銃	铳
銈	𫓯
銊	𫓰
銍	铚
銑	铣
銓	铨
銖	铢
銗	𬭅
銘	铭
銠	铑
銡	𰽲
銥	铱
銦	铟
銧	𰽵
銨	铵
銩	铥
銪	铕
銫	铯
銬	铐
銱	铞
銲	𬭍
銳	锐
銴	𨦬
銶	𨱇
銷	销
銸	𰽿
銹	锈
銻	锑
銼	锉
銾	𰾁
鋁	铝
鋃	锒
鋅	锌
鋆	𬫔
鋇	钡
鋊	𰾆
鋋	𮣴
鋌	铤
鋏	铗
鋐	𬭎
鋒	锋
鋚	𨦷
鋟	锓
鋠	𫓵
鋡	𰾅
鋤	锄
鋥	锃
鋦	锔
鋨	锇
鋪	铺
鋮	铖
鋯	锆
鋰	锂
鋱	铽
鋴	𭴨
鋶	锍
鋷	𨭵
鋸	锯
鋹	𬬮
鋾	𰾏
錁	锞
錃	𨧦
錆	锖
錇	锫
錈	锩
錋	𬭖
錏	铔
錐	锥
錒	锕
錓	𨪢
錕	锟
錗	𬭗
錙	锱
錚	铮
錛	锛
錜	𫓻
錝	𫓽
錠	锭
錡	锜
錤	𫓹
錥	𫓾
錧	𰾒
錨	锚
錩	锠
錪	𬭓
錭	𬭕
錮	锢
錯	错
錳	锰
錵	𨨉
錶	𰾍
錸	铼
鍀	锝
鍁	锨
鍂	𰾑
鍃	锪
鍄	𨱉
鍆	钔
鍇	锴
鍈	锳
鍉	𫔂
鍍	镀
鍎	𨨷
鍏	𬬬
鍐	鑁
鍒	𫔄
鍔	锷
鍖	𰾘
鍘	铡
鍛	锻
鍜	𰾤
鍝	𰾙
鍠	锽
鍡	𰾚
鍤	锸
鍥	锲
鍨	𰾥
鍩	锘
鍬	锹
鍯	𬭥
鍴	𰾜
鍵	键
鍶	锶
鎂	镁
鎄	锿
鎅	𰾛
鎇	镅
鎈	𫟿
鎊	镑
鎋	𬭪
鎌	𰾮
鎍	𫔅
鎐	𨨳
鎑	𰾩
鎓	𬭩
鎔	镕
鎕	𰾯
鎖	锁
鎛	镈
鎠	𮢟
鎢	钨
鎦	镏
鎧	铠
鎩	铩
鎪	锼
鎮	镇
鎰	镒
鎳	镍
鎵	镓
鎶	鿔
鎷	𨰾
鎸	镌
鎿	镎
鏁	𬭲
鏆	𨱌
鏈	链
鏌	镆
鏍	镙
鏐	镠
鏑	镝
鏔	𬭰
鏕	𰾲
鏗	铿
鏙	𰾰
鏜	镗
鏝	镘
鏟	铲
鏡	镜
鏢	镖
鏥	𫔊
鏨	錾
鏩	𰾌
鏰	镚
鏲	𨩏
鏵	铧
鏶	鍓
鏷	镤
鏻	𬭸
鏾	𫔌
鐁	𰾴
鐃	铙
鐄	𨱑
鐇	𫔍
鐈	𫓱
鐊	𬭏
鐍	𫔎
鐎	𨱓
鐏	𨱔
鐒	铹
鐓	镦
鐔	镡
鐖	𰽕
鐘	钟
鐚	𰾪
鐜	𨰩
鐝	镢
鐠	镨
鐢	𨪧
鐣	𨭃
鐤	𰾸
鐥	䦅
鐦	锎
鐧	锏
鐨	镄
鐬	𰽷
鐮	镰
鐱	𰼳
鐲	镯
鐳	镭
鐶	镮
鐼	𫔁
鐽	𫟼
鐿	镱
鑀	𰾭
鑁	𰾞
鑆	𨮝
鑉	𫠁
鑒	鉴
鑓	𨯯
鑔	镲
鑕	锧
鑖	𰿃
鑞	镴
鑠	铄
鑥	镥
鑨	𰽦
鑬	𫔃
鑭	镧
鑵	𨫝
鑷	镊
鑸	𰿉
鑼	锣
鑾	銮
钃	𰾽
钆	釓
钇	釔
钉	釘
钊	釗
钋	釙
钌	釕
钎	釺
钑	鈒
钒	釩
钔	鍆
钙	鈣
钚	鈈
钛	鈦
钜	鉅
钞	鈔
钠	鈉
钡	鋇
钣	鈑
钨	鎢
钪	鈧
钫	鈁
钬	鈥
钭	𨥪
钯	鈀
钰	鈺
钱	錢
钲	鉦
钴	鈷
钶	鈳
钷	鉕
钸	鈽
钼	鉬
钽	鉭
钾	鉀
铀	鈾
铂	鉑
铈	鈰
铉	鉉
铋	鉍
铌	鈮
铎	鐸
铑	銠
铒	鉺
铓	𨦵
铙	鐃
铛	鐺
铜	銅
铝	鋁
铞	銱
铟	銦
铢	銖
铤	鋌
铥	銩
铪	鉿
铬	鉻
铭	銘
铯	銫
铰	鉸
铱	銥
铵	銨
铷	銣
铹	鐒
铼	錸
锂	鋰
锆	鋯
锇	鋨
锌	鋅
锍	鋶
锎	鐦
锑	銻
锓	鋟
锕	錒
锗	鍺
锘	鍩
锝	鍀
锞	錁
锟	錕
锠	錩
锢	錮
锥	錐
锧	鑕
锩	錈
锪	鍃
锬	錟
锭	錠
锰	錳
锳	鍈
锴	鍇
锶	鍶
锺	𦉂
镀	鍍
镁	鎂
镃	鎡
镄	鐨
镅	鎇
镆	鏌
镈	鎛
镉	鎘
镋	钂
镍	鎳
镐	鎬
镑	鎊
镓	鎵
镔	鑌
镕	鎔
镙	鏍
镚	鏰
镟	鏇
镥	鑥
镨	鐠
镪	鏹
镭	鐳
镯	鐲
镱	鐿
镸	⻒
镹	𮩶
镺	𨱩
镻	𨱷
镽	𩯊
閃	闪
閄	𬮘
閆	闫
閈	闬
閌	闶
閍	𨸂
閏	闰
閐	𨸃
閑	闲
閔	闵
閕	𰿩
閗	𫔯
閘	闸
閟	𮤲
閣	阁
閤	𬮤
閥	阀
閧	𬮢
閨	闺
閩	闽
閬	阆
閯	𬮪
閶	阊
閹	阉
閼	阏
閽	阍
閾	阈
闄	𬮲
闅	閺
闇	𬮴
闈	闱
闊	阔
闋	阕
闍	阇
闐	阗
闑	𫔶
闒	阘
闓	闿
闕	阙
闚	𬮭
闛	𰿺
闡	阐
闤	阛
闥	闼
闫	閆
闬	閈
闳	閎
闶	閌
闺	閨
闼	闥
闾	閭
闿	闓
阀	閥
阏	閼
阒	闃
阓	闠
阝	⻖
阣	𨸛
阤	陁
阮	阮
阰	𨻀
阹	𪪕
阺	𨸞
阻	𰜘
陒	𨹣
陔	垓
陘	陉
陝	陕
陣	阵
陧	𨻄
陪	𨻓
陯	𬤳
陼	陼
隂	𨼲
隇	𨻒
隊	队
隋	𫔽
隌	𬯂
隒	𱀶
隕	陨
際	际
隣	隣
隨	随
隩	墺
隬	𱀾
隯	陦
隱	隐
隲	𱀑
隹	⾫
隺	𡨱
隼	鶽
雂	𨾠
雃	雃
雊	㗕
雋	𮥼
雐	𭼲
雔	㘜
雗	𨿨
雙	双
雛	雏
雡	𱁌
雧	𰍜
雯	𫕦
雰	𩃼
雱	䨦
電	电
霅	𤁳
霏	䬠
霐	䨎
霒	霠
霕	𩃌
霙	𩄪
霜	𩅪
霧	雾
霫	雭
露	露
霼	𪵣
靂	雳
靃	𱁫
靄	霭
靉	叆
靊	霻
靔	靝
靘	䒌
靚	靓
靜	静
靝	靔
靨	靥
靬	𩎒
靲	𩎖
靹	䪏
鞁	𩌟
鞇	𩎪
鞐	𬰬
鞔	𩋭
鞕	𩋸
鞗	𠌙
鞡	𩋷
鞣	𦎤
鞤	𥀂
鞥	𩊕
鞲	𦃪
鞸	𱁴
鞾	𫖇
鞿	𩉜
韃	鞑
韄	䪝
韇	𱁷
韉	鞯
韊	𱁾
韌	韧
韒	𱂉
韓	韩
韖	䂋
韙	韪
韚	𫠅
韜	韬
韰	𩐂
韹	𨉤
韻	𱂐
頂	顶
頃	顷
頄	𬱓
項	项
須	须
頊	顼
頌	颂
頎	颀
頏	颃
頑	顽
頒	颁
頓	顿
頔	𬱖
頕	𬱗
頖	𬱙
頗	颇
頙	𩑠
頜	颌
頟	𱂥
頠	𬱟
頡	颉
頤	颐
頦	颏
頨	𩑧
頭	头
頮	颒
頰	颊
頲	颋
頴	颕
頵	𫖳
頽	颓
顀	𱂭
顁	𬱫
顂	𩓋
顃	𩖖
顅	𫖶
顆	颗
顇	𱂯
顈	𦅐
顉	𰽳
顊	𬱪
顋	𱂲
題	题
額	额
顎	颚
顏	𩠪
顐	𬱢
顒	颙
顓	颛
顔	颜
顖	𱂶
顙	颡
顜	𱂴
顝	𱂵
顠	𱂺
顢	颟
顤	𱂣
顥	颢
顨	𩕧
顪	𱂤
顫	颤
顬	颥
顭	𩕫
顰	颦
顱	颅
顳	颞
顴	颧
顸	頇
顼	頊
顽	頑
颀	頎
颉	頡
颕	頴
颛	顓
颞	顳
颟	顢
颩	𱃔
颪	𭂳
颫	𩖬
颬	𱃕
颱	𱃗
颵	䬘
颶	飓
颷	𩙪
颸	飔
颻	飖
颿	𬳳
飄	飘
飆	飙
飇	𱃠
飈	飚
飊	𮗝
飋	𫗋
飍	𱃝
飏	颺
飠	𩙿
飣	饤
飦	𫗞
飨	饗
飩	饨
飫	饫
飬	𫑩
飭	饬
飮	𫨜
飰	𱃴
飶	𫗣
飷	𬲭
飻	𬲍
飿	饳
餂	𱃺
餃	饺
餄	饸
餅	饼
餉	饷
餋	飬
餌	饵
餎	饹
餏	饻
餑	饽
餒	馁
餓	饿
餖	饾
餛	馄
餜	馃
餟	𬳂
餡	馅
餢	𱃾
餣	𬲼
餤	𱃿
餦	𫗠
餧	𫗪
餫	𫗥
餱	𫗯
餴	𱃼
餵	𫗭
餶	馉
餷	馇
餸	𩠌
餹	𬳍
餺	馎
餼	饩
餾	馏
餿	馊
饁	馌
饅	馒
饇	𱃲
饉	馑
饊	馓
饌	馔
饏	䭛
饜	餍
饞	馋
饟	𫗵
饧	餳
饯	餞
饳	飿
饸	餄
饹	餎
饺	餃
饻	餏
饽	餑
饿	餓
馁	餒
馂	餕
馃	餜
馇	餷
馉	餶
馛	𥣣
馠	𩠻
馦	㽐
馧	馧
馩	𬳟
馮	冯
馱	驮
馳	驰
馴	驯
馹	驲
駁	驳
駃	𫘝
駍	𬳴
駎	𩧨
駑	驽
駒	驹
駔	驵
駕	驾
駘	骀
駛	驶
駞	𫘞
駟	驷
駠	𩢞
駤	𫘠
駦	𱅑
駧	𩧲
駫	𫘡
駬	𱅋
駮	𱅐
駰	骃
駴	𮪢
駵	𩤷
駶	𩧺
駷	𱅔
駸	骎
駺	𬴀
駿	骏
騁	骋
騂	骍
騃	𫘤
騄	𫘧
騅	骓
騆	𩤫
騉	𫘥
騋	𱅕
騌	骔
騍	骒
騏	骐
騔	𩨀
騖	骛
騗	𱅝
騙	骗
騚	𩨊
騝	𩨃
騟	𩨈
騢	𱅞
騤	骙
騥	𱅟
騫	骞
騭	骘
騰	腾
騲	𮪤
騴	𫘫
騵	𫘪
騶	驺
騸	骟
騹	𬴆
騻	𫘭
騼	𫠋
騽	𱅩
騾	骡
驀	蓦
驁	骜
驃	骠
驊	骅
驋	𩧯
驍	骁
驏	骣
驐	𮪥
驕	骄
驘	𩥡
驙	𫘰
驚	惊
驜	𩦭
驝	𬴎
驠	𱅬
驡	𱅅
驤	骧
驥	骥
驯	馴
驷	駟
驻	駐
骉	驫
骑	騎
骒	騍
骓	騅
骕	驌
骞	騫
骬	𩨗
骮	䯆
骶	𩨤
骼	𬴒
骾	𩩹
髁	𡱼
髉	𩪓
髎	𩪚
髏	髅
髐	𱅮
髑	䫳
體	体
髕	髌
髖	髋
髞	𩫦
髠	𨱤
髶	𩮙
髸	𪞋
髼	𩭉
髾	𨲆
鬀	𨲙
鬁	𩯬
鬆	䯳
鬋	𩮣
鬎	𩯽
鬗	𱆆
鬜	𱆁
鬠	𫘽
鬧	闹
鬬	闘
鬭	𬆱
鬮	阄
鬰	𣡇
鬶	鬹
鬸	𦉉
鬹	鬶
鬽	𢑛
鬿	𩲪
魀	𩳻
魆	𪐶
魎	魉
魔	𮭺
魙	𩴕
魛	鱽
魜	𬶁
魠	𱇏
魡	𬶄
魢	鱾
魥	𩽹
魦	𫚌
魨	鲀
魬	𱇖
魴	鲂
魵	𫚍
魶	𱇔
魷	鱿
魺	鲄
魻	𱇟
魼	𱇜
魽	𫠐
鮃	鲆
鮄	𫚒
鮇	𱇛
鮈	𬶋
鮊	鲌
鮋	鲉
鮌	𱇢
鮍	鲏
鮎	鲇
鮏	𱇡
鮐	鲐
鮒	鲋
鮕	𩾀
鮗	鿴
鮘	𬶌
鮚	鲒
鮛	𱇨
鮜	鲘
鮞	鲕
鮟	𩽾
鮠	𬶏
鮣	䲟
鮥	𱇪
鮦	鲖
鮧	𱇧
鮩	𩹁
鮪	鲔
鮫	鲛
鮮	鲜
鮯	𫚗
鮵	𫚛
鮶	鲪
鮷	𬶕
鮹	𱇯
鮺	鲝
鮿	𫚚
鯀	鲧
鯁	鲠
鯂	𩹠
鯅	𱈁
鯇	鲩
鯈	𱇱
鯊	鲨
鯌	𬶔
鯕	鲯
鯖	鲭
鯗	𩺁
鯘	脮
鯚	𱇺
鯛	鲷
鯝	鲴
鯞	𫚡
鯠	𱇭
鯡	鲱
鯢	鲵
鯤	鲲
鯥	𱇶
鯧	鲳
鯩	𱇗
鯪	鲮
鯫	鲰
鯯	䱥
鯰	鲶
鯱	𩾇
鯴	鲺
鯵	鲹
鯶	𩽼
鯽	鲫
鯾	𫚣
鯿	鳊
鰁	鳈
鰃	鳂
鰅	𱈂
鰆	䲠
鰇	𬶧
鰈	鲽
鰉	鳇
鰊	𬶠
鰍	鳅
鰎	𩻥
鰏	鲾
鰑	𫚊
鰓	鳃
鰕	𫚥
鰗	𬶞
鰙	𬵫
鰜	鳒
鰝	𱈋
鰠	鳋
鰣	鲥
鰤	𫚕
鰨	鳎
鰩	鳐
鰪	𩺻
鰫	𫚦
鰯	𱈍
鰱	鲢
鰲	鳌
鰳	鳓
鰵	鳘
鰶	𬶭
鰷	鲦
鰺	鯵
鰻	鳗
鰼	鳛
鰽	𫚧
鰾	鳔
鱁	𱈏
鱂	鳉
鱃	𱈌
鱅	鳙
鱆	𫠒
鱈	鳕
鱉	鳖
鱊	𫚪
鱋	𬶬
鱌	𬶲
鱐	𱇿
鱑	𬶫
鱒	鳟
鱓	𬶛
鱕	𱈕
鱖	鳜
鱘	鲟
鱚	𬶮
鱝	鲼
鱞	𬶵
鱟	鲎
鱠	鲙
鱡	𩽠
鱢	𫚫
鱤	鳡
鱥	𮬝
鱧	鳢
鱩	鰰
鱪	鱰
鱭	鲚
鱮	𫚈
鱯	鳠
鱳	𩺮
鱹	𬶺
鱺	鲡
鱻	𱈜
鱽	魛
鱾	魢
鱿	魷
鲀	魨
鲂	魴
鲆	鮃
鲉	鮋
鲍	鮑
鲎	鱟
鲐	鮐
鲖	𩻡
鲙	鱠
鲚	鱭
鲛	鮫
鲡	鱺
鲪	鮶
鲬	鯒
鲭	鯖
鲮	鯪
鲰	鯫
鲱	鯡
鲴	鯝
鲵	鯢
鲶	鯰
鲺	鯴
鲾	鰏
鳀	鯷
鳁	鰛
鳂	鰃
鳃	鰓
鳈	鰁
鳐	鰩
鳓	鰳
鳕	鱈
鳙	鱅
鳚	𩻍
鳛	鰼
鳜	鱖
鳟	鱒
鳤	䲘
鳨	𩾜
鳪	𨾇
鳮	𠭬
鳲	鸤
鳴	鸣
鳵	𩾨
鳷	𫛛
鳾	䴓
鴀	𫛜
鴁	𮭢
鴉	鸦
鴍	𬸀
鴒	鸰
鴕	鸵
鴖	𪃯
鴗	𫁡
鴘	𱉡
鴙	𱉛
鴜	𪉈
鴞	鸮
鴟	鸱
鴣	鸪
鴦	鸯
鴨	鸭
鴩	𱉚
鴯	鸸
鴲	𪉆
鴴	鸻
鴶	𱉥
鴺	𱉩
鴻	鸿
鴾	𱉲
鴿	鸽
鵂	鸺
鵃	鸼
鵄	𬸈
鵊	𫛥
鵍	𪁤
鵎	𱉻
鵐	鹀
鵒	鹆
鵓	鹁
鵕	𱉾
鵖	𱉝
鵜	鹈
鵝	鹅
鵠	鹄
鵣	𪀜
鵨	𪅰
鵪	鹌
鵮	鹐
鵯	鹎
鵰	𫛲
鵲	鹊
鵶	𱉨
鵷	鹓
鵺	𨿤
鵼	𱊊
鵾	鹍
鶀	𬸒
鶁	𬷦
鶃	𱊄
鶆	𱉵
鶇	鸫
鶈	𨿩
鶉	鹑
鶊	鹒
鶋	𱊌
鶌	𫛵
鶍	𬷢
鶓	鹋
鶔	𱊗
鶕	𬸝
鶖	鹙
鶘	鹕
鶙	𱊕
鶢	𱊒
鶣	𬸜
鶤	𱉱
鶥	鹛
鶦	𫛷
鶧	𪃳
鶬	鸧
鶭	𫛯
鶱	𬸣
鶲	鹟
鶵	𬸅
鶹	鹠
鶺	鹡
鶻	鹘
鶼	鹣
鶾	𪂂
鶿	𮭋
鷀	鹚
鷅	𫛽
鷊	鹝
鷋	𱊠
鷓	鹧
鷔	𪉑
鷖	鹥
鷞	𮭪
鷡	𨿏
鷤	𫛴
鷦	鹪
鷰	𬸧
鷱	𩀹
鷲	鹫
鷴	鹇
鷵	𱊩
鷷	𫜄
鸁	𱊮
鸄	𱊯
鸆	𱊫
鸌	鹱
鸏	鹲
鸐	𱊱
鸔	𱉆
鸖	𬸰
鸙	𱊵
鸚	鹦
鸝	鹂
鸮	鴞
鸴	鷽
鸶	鷥
鸻	鴴
鹔	鷫
鹖	鶡
鹛	鶥
鹟	鶲
鹠	𪅳
鹢	鷁
鹣	鶼
鹥	鷖
鹴	鸘
鹸	𫠗
鹼	鹸
麁	𡘛
麃	𤐅
麆	𪊹
麉	𪊑
麌	𬸿
麐	𪊎
麒	𪊔
麘	𪋒
麡	𬸾
麣	𪋹
麩	麸
麭	𮮆
麱	𱋖
麲	𪎉
麹	𪌲
麺	𪋽
麼	𮮍
黀	𪎪
黃	黄
黇	𪏊
黋	𤾗
黕	𪐨
黗	𪐠
點	点
黡	黶
黨	党
黩	黷
黪	黲
黫	𪑸
黭	𪒈
黲	黪
黵	𪒧
黷	黩
黸	𱋶
鼃	𪓤
鼄	𬹣
鼆	𱌆
鼉	鼍
鼚	𱌊
鼟	𣫤
鼣	𪕟
鼥	𪖆
鼧	𪕅
鼩	𪖏
鼭	𪕵
鼴	𪕤
鼷	𭀹
鼹	鼴
齁	𪖙
齃	齃
齄	㾴
齈	𱌖
齉	儾
齙	龅
齚	𱌬
齞	𱌫
齠	龆
齢	𬹴
齥	𱌱
齪	龊
齱	𱌶
齷	龌
齸	𱌽
齽	𬺔
龁	齕
龂	㹞
龐	庞
龔	龚
龗	𪚙
龘	𮄿
龝	𬓫
龞	𱍈
龥	𬱳
龭	𩨎
龯	𨱆
龲	𰾋
龻	𰁜
龽	𰞳
鿀	𰱃
鿁	䜤
鿃	睒
鿄	𬇲
鿐	䲤
鿓	鿒
鿕	𱆥
鿟	鿠
鿳	鿸
鿸	鿳
𠁏	𠁐
𠁕	𠁏
𠁞	𠀾
𠁹	𠁵
𠂆	𰀪
𠂖	𠂙
𠂣	𡰧
𠃅	𡣧
𠃊	𠃑
𠃨	𤓯
𠄃	𠄄
𠄉	𧳿
𠄍	𠂈
𠄑	𡳾
𠅨	𠅬
𠅬	𥨆
𠅲	𬽑
𠆎	𩎮
𠆒	𦤘
𠆙	𠆓
𠆩	仮
𠆪	𠇃
𠆶	𠇵
𠆻	𫧹
𠇘	𫯢
𠇽	𠇆
𠊔	𢔆
𠋉	𬾘
𠋶	𫣎
𠌎	𬊞
𠌞	𫣋
𠌡	㮸
𠌢	𠈻
𠌥	𠆿
𠍐	𡦈
𠍦	𫢲
𠍴	𠎱
𠍺	𨂮
𠎅	𰂃
𠎒	𫢨
𠎟	𠎂
𠎦	𠍋
𠏮	𫢘
𠏾	𠑞
𠐊	𫝋
𠐍	𫣫
𠐩	𠑑
𠐮	𬾣
𠐽	𫢔
𠐿	𩖎
𠑅	𠐏
𠑇	𰂻
𠑙	𫢹
𠑚	𠑛
𠑲	𫣛
𠒐	𠓈
𠓓	𨮠
𠓖	𠓚
𠓧	𠓢
𠓭	𢞥
𠓲	𣔕
𠓷	𠓵
𠓹	𠓻
𠔎	𠇨
𠔜	𠔜
𠕭	𠕥
𠖷	㓏
𠗉	𠖹
𠗙	𠗴
𠗣	㓆
𠗨	𠗛
𠗿	𰄁
𠘂	凁
𠘆	𠘏
𠘇	𠘒
𠘖	𤁩
𠘞	𤁼
𠘢	𠘇
𠙆	𠙏
𠙦	䒮
𠚊	𠚍
𠚜	𤔱
𠚞	𤔼
𠚨	𠠳
𠚪	𠠴
𠚯	𡯇
𠛋	𫥴
𠛎	𠚸
𠛔	𠚷
𠛪	𠜩
𠜅	𫥿
𠜱	𠞇
𠜵	𡘢
𠝝	𠝚
𠝞	𠜕
𠝬	𠝠
𠝿	𫦁
𠞆	𠛆
𠞖	𠠖
𠞘	𠞻
𠞭	𫦉
𠞿	𠟓
𠟈	𠢪
𠟊	𠟖
𠟍	𠝤
𠟪	𫥺
𠟰	𠠘
𠟽	𠟗
𠠁	䥪
𠠄	𠠄
𠠏	𫥵
𠠜	𫦕
𠠠	𠠔
𠠫	𰄭
𠠯	𫦡
𠠻	𠡀
𠡜	𠡤
𠡡	𠡹
𠡭	𪋾
𠡸	𠡯
𠢍	𠢅
𠢕	𠞪
𠢡	𠢙
𠢤	𠢭
𠢦	𪬈
𠢱	𠢵
𠣞	𠣞
𠣤	𢞛
𠣬	𠣤
𠤒	𠈔
𠤕	𫶬
𠤗	𢁄
𠤦	𠤥
𠤴	𠥁
𠤼	𠥌
𠤾	𠤿
𠥇	𠥵
𠥰	𰅫
𠥴	𭅛
𠦫	𠦣
𠧛	𰁗
𠧪	𠨋
𠧴	𠅓
𠧽	𤈭
𠨎	𠨓
𠨬	𠨬
𠨲	𠩃
𠩘	𫨆
𠩪	𠩆
𠩫	𰆞
𠩬	𰆙
𠩭	𫸇
𠩸	𫷸
𠩼	𫨃
𠪂	𠩲
𠪇	𠩹
𠪚	𭆕
𠪟	𠪒
𠫓	𡿮
𠫞	𠫨
𠬙	𪠡
𠬝	𢻮
𠬬	𠬰
𠭆	𡷮
𠭋	𣤌
𠭘	𬆓
𠭣	𠭣
𠭥	𢿆
𠭰	𠭷
𠮫	𠮬
𠮳	𭆽
𠮽	𭆼
𠯂	𡥄
𠯔	𠰊
𠯦	切
𠯬	𠯙
𠰇	𠰡
𠰑	𪴪
𠰠	𠲬
𠱖	𠳱
𠱘	𠸺
𠱡	𠵡
𠱥	𠾭
𠱧	𠱦
𠲊	𠳰
𠲻	𣻂
𠳎	㕽
𠳬	𰅶
𠴁	𠵑
𠴟	哶
𠴨	𠶽
𠴫	𠱙
𠵇	𫫀
𠵘	𫩖
𠵹	𫩚
𠶲	𠷄
𠶷	訲
𠶹	𰇡
𠷌	𰇘
𠷎	𠃬
𠷏	𫡬
𠷑	㗶
𠹃	𧪪
𠹍	𠺀
𠹛	𫩯
𠹾	𠺥
𠺖	𭈈
𠺪	𠯏
𠺮	𫪅
𠻜	𠱕
𠻠	𠾥
𠻤	𪡣
𠻲	𭊆
𠼕	𡁭
𠼗	𫪚
𠼢	𭌡
𠼤	𫪄
𠼮	𫩳
𠽈	𭈟
𠽪	𠻪
𠽵	𡁄
𠽼	譅
𠿓	㗺
𠿜	㼫
𠿞	𭋢
𠿡	𠼆
𠿾	𫫡
𠿿	𭇀
𡀠	𭈜
𡀿	𫫵
𡁀	𠾗
𡁈	𡅼
𡁍	𡁁
𡁎	𫬁
𡁓	𧭌
𡁚	𭇙
𡁛	𭌽
𡁟	𰈚
𡁯	𭇡
𡂙	𡁂
𡂡	𪢒
𡂪	𡂭
𡂿	𫪘
𡃄	𪡺
𡃈	𰈮
𡃸	𭌦
𡄇	𭌏
𡄑	𭋲
𡄒	𥗚
𡄖	𭈉
𡄣	𠵸
𡅁	𡅓
𡅕	𫬔
𡅖	𮊶
𡅥	𫬟
𡅧	𭉼
𡅯	𪢖
𡆎	𩉊
𡆪	㘟
𡇢	𡈔
𡇵	𡇈
𡈢	𡈷
𡉄	圣
𡉉	𡴊
𡉟	壮
𡉺	𪢿
𡊻	𡎗
𡋪	𰆃
𡋯	𡍧
𡌛	𭎢
𡌿	𫮎
𡍦	𨌗
𡍩	𰊋
𡍪	𡎫
𡍫	𫭮
𡎉	𥀁
𡎢	𡎦
𡎥	𫮋
𡎨	𣦣
𡎷	𰊙
𡎻	𡌚
𡏅	鿾
𡏋	𰊉
𡏝	𡏫
𡐣	𡑉
𡐥	𡒁
𡑍	𫭼
𡑑	𡐀
𡑭	𡋗
𡑯	𰉱
𡑵	𡍙
𡒓	𥃆
𡒶	𡏆
𡓁	𪤄
𡓉	𡓷
𡓍	𡒏
𡓤	𡓤
𡓦	𰊅
𡓸	𣦯
𡓾	𡋀
𡔉	𡔓
𡔕	𡎴
𡖓	𢑝
𡖞	𡖤
𡖻	𡖽
𡖾	𪀩
𡗅	𬩍
𡗆	𰋖
𡗞	𡗳
𡗷	𡘎
𡗼	𡘌
𡘍	𡘟
𡘛	𡘘
𡘩	𠅲
𡙇	𭏮
𡙛	𡙠
𡙧	𤞽
𡙷	𤐁
𡚂	𡙼
𡚇	𡙷
𡚤	𧹈
𡚨	𡚨
𡚮	𡚰
𡚴	妛
𡚻	𫰜
𡛖	𡚲
𡛪	𡛪
𡜍	𡟴
𡝋	𡟘
𡝐	𡝙
𡝵	𫰓
𡞨	𩮆
𡞫	𡞏
𡞵	㛟
𡟑	𡞥
𡟟	𡠴
𡟨	𨻤
𡟫	𫝪
𡟳	𫾺
𡟷	𡠖
𡠋	𡟪
𡠚	𰋾
𡠹	㛿
𡡂	𡠘
𡡤	𡚫
𡡥	𡞮
𡢃	㛠
𡢌	𡡨
𡢘	𰌉
𡢠	𫲄
𡢱	𡣋
𡢿	𭑸
𡣈	㛸
𡣊	𡣔
𡣔	𡣤
𡣨	𡡇
𡤓	𪦲
𡤝	𬷭
𡤠	𫰣
𡤧	𡝬
𡤫	𫱿
𡥉	𠭂
𡥓	𣫮
𡥧	𡦌
𡦙	𡽿
𡦟	𩫫
𡦲	𡦵
𡦵	𬋽
𡧗	𥥟
𡧭	𢈌
𡩄	𫁕
𡩆	𬆊
𡩛	𡪸
𡩤	㝜
𡪁	𰍍
𡪋	𡢑
𡪶	𡬖
𡫚	𥛛
𡫧	𡫔
𡫸	𡬗
𡫺	𡬇
𡫽	𥨲
𡬌	𡬋
𡬏	𡬀
𡬖	𥩒
𡬯	𡬸
𡬳	𭆲
𡭀	𡭈
𡭒	𤔺
𡮉	𡭜
𡮤	𫴼
𡮬	𡮮
𡯄	𠠵
𡯉	𡯅
𡯋	𢆋
𡯑	㝽
𡯥	𧉇
𡯫	𡯬
𡯭	𡯲
𡯳	𡯷
𡯴	𫵑
𡰑	𡰘
𡰒	𡰕
𡰠	𡰟
𡰢	𡰡
𡱁	𥺶
𡱂	𩪔
𡱒	𫵕
𡱷	𡱡
𡲪	𡥸
𡳞	𨶙
𡳸	𭕵
𡴋	𡴋
𡴔	𡴒
𡴘	𪜏
𡴭	𡴯
𡴰	𫝳
𡴵	𫵲
𡵃	屽
𡵜	㞲
𡵬	𡵵
𡶃	𡺬
𡶙	𡶔
𡶪	𥐢
𡷕	𡷱
𡷛	𡵃
𡷤	𡷤
𡷦	𡷦
𡷧	㖗
𡸀	𭖣
𡸎	𭖻
𡸑	𫶁
𡸔	𦋅
𡸗	𪨩
𡸜	𡸽
𡸦	𡵗
𡸨	𡸘
𡹐	𡺾
𡹛	𪨿
𡹵	𡺝
𡺜	𡹳
𡺠	𰎝
𡺡	𡺦
𡺢	𡹨
𡺨	𫵶
𡺭	𡻃
𡺸	𭗈
𡺺	𡾈
𡻀	𡻹
𡻊	𡻘
𡻌	𨑆
𡻑	𡺪
𡻕	𪩈
𡻟	㵹
𡻢	𡻽
𡻪	𡽐
𡻬	𡷿
𡻵	𡻫
𡼁	𡴥
𡼬	𡼒
𡼱	𰎢
𡼾	𰎛
𡼿	𥖚
𡽑	𡸾
𡽗	𡸃
𡽜	𧪙
𡽳	𫶊
𡽴	𡾻
𡽵	𫵹
𡾆	𰎷
𡾟	𡾠
𡾮	𭗴
𡾰	𡼌
𡾱	㟜
𡿄	𭗶
𡿇	𡿏
𡿊	𡷙
𡿝	𥗾
𡿩	𡿪
𡿯	𣅕
𡿼	𰏄
𢀷	𨚡
𢁋	𪩮
𢁕	𢄦
𢁟	𪤷
𢁼	𢅔
𢂁	𢄠
𢃎	𢃤
𢃳	𢑦
𢄋	𦭬
𢄓	𰏓
𢄟	𢂓
𢄦	𩓩
𢄧	𢄲
𢄺	𧝈
𢅏	𢅳
𢅑	繺
𢅡	𫷌
𢅫	𢄣
𢅮	𢅲
𢆃	𢆃
𢆉	𦍍
𢆞	𤩘
𢆣	𠆕
𢆴	𢆳
𢆶	𢆾
𢆷	𢇄
𢇁	𢇃
𢇧	𢇰
𢈓	𭙎
𢈞	𢈬
𢈩	𢉇
𢉨	𢈠
𢉿	𰏲
𢊁	𧳋
𢋇	𠪯
𢋊	𢋘
𢋔	𢇣
𢋛	𢊵
𢋻	𢌃
𢌔	𧯙
𢌦	𢽄
𢌫	𩮆
𢍁	𢍉
𢍰	𪪴
𢍱	𦧂
𢏯	𢏶
𢐊	𢎷
𢐕	𫸰
𢑆	𢎠
𢑇	𢏉
𢑎	𢑍
𢒉	𧴭
𢓆	𢓃
𢓊	𬠿
𢓒	𢓏
𢓙	𢓻
𢓡	𢓚
𢓨	𤝱
𢓯	𠍧
𢓱	𢕝
𢔈	𢔔
𢔥	𧼫
𢔳	𢕉
𢕖	𢖎
𢕚	𫥐
𢕩	𢕇
𢕭	𧯘
𢕺	𢖌
𢕻	𨗧
𢖊	𢓳
𢖥	𦇺
𢖫	𢖰
𢗏	𢗻
𢘀	𭜞
𢘅	𢘕
𢘞	𢣭
𢘿	𰒂
𢙱	㑝
𢙸	𠎹
𢙿	㦗
𢚸	𪫵
𢛃	㤹
𢛈	𪬍
𢛉	𢛊
𢛦	𢜕
𢜗	𢗒
𢜟	𰑂
𢜲	𢝟
𢜳	㥉
𢜵	𢜴
𢜶	𢠡
𢜷	𦓖
𢜸	𢥝
𢜻	𢟊
𢜽	𠋳
𢝁	𢤀
𢝌	𢛡
𢝹	𢞖
𢝽	𢝠
𢞏	𢖸
𢞓	𢚜
𢞗	𭝰
𢟊	𢜼
𢟢	𢥗
𢟧	𢢛
𢟪	𡦎
𢠕	𢡡
𢠠	𢟭
𢠰	𰑅
𢠲	㤱
𢠼	𢙑
𢡄	𢡄
𢡊	𢡊
𢢀	𫺒
𢢜	𭞴
𢢞	𢤙
𢢰	𢤋
𢣊	𦡗
𢣏	㦈
𢣐	𪬚
𢣗	𨣴
𢣙	𢤨
𢣚	𢘝
𢤌	𫻇
𢤐	𢥍
𢤧	𰒖
𢤩	𪫡
𢤰	𢤕
𢤱	𢘙
𢤽	𢣹
𢤾	𢚙
𢤿	𪬯
𢥇	𢤚
𢥘	𢤮
𢥰	𢤉
𢥻	𭟧
𢦔	𰗒
𢦪	𫻦
𢧀	𰐎
𢧖	𢧻
𢧜	㦶
𢧤	𡙮
𢧴	𢦷
𢨨	𢩂
𢩝	𢩗
𢩞	𢨧
𢪇	𢪫
𢪈	𫨳
𢪋	𢪮
𢪍	𢷿
𢪏	𬁧
𢪑	𬆟
𢪒	𫽓
𢪬	𣏺
𢪹	𢫂
𢪼	𢫤
𢫙	𪭩
𢫿	𪡘
𢬌	𢬌
𢬜	挔
𢬟	𢬆
𢬢	𢬚
𢬬	𨛾
𢬶	𢱥
𢭀	𪭻
𢭄	𢪕
𢮎	𫾹
𢮞	𢫺
𢮨	𦝏
𢯩	𫼤
𢯭	𣕂
𢯮	𢶂
𢯱	𠮍
𢯳	乴
𢯷	𪭝
𢯺	䄔
𢯼	𢫱
𢰀	𢺊
𢰄	𫸞
𢰺	𫼨
𢱕	𠳖
𢱖	𪮍
𢱝	𢱞
𢱡	𫼶
𢱫	𰓾
𢲐	𰓝
𢲩	𫼾
𢲫	𫼗
𢲵	𪯓
𢲶	𠁠
𢲸	𫼵
𢲾	𫼫
𢳃	𢷍
𢳈	𢳇
𢳚	𫽐
𢴖	𰓸
𢴦	𫽙
𢴩	𫽳
𢴬	𢲔
𢴶	𢷭
𢵌	𢵩
𢶀	𢶓
𢶍	㩑
𢶏	𢷋
𢶐	𬋵
𢶑	𫽲
𢶕	𢶨
𢶢	𢴞
𢶫	𢫞
𢶯	𰒽
𢶶	𤢛
𢶼	𢶟
𢷃	𫽔
𢷍	𢰽
𢷏	𢪗
𢷖	𢹴
𢷘	𢶊
𢷞	𦾃
𢷮	𢫊
𢷶	𢷚
𢸙	𩮆
𢸳	𫾃
𢸴	𫾁
𢸸	𰓕
𢸾	𢷲
𢹏	𰔶
𢹔	𣠂
𢹥	𰓗
𢹦	𫾛
𢹼	𰓟
𢹿	𢬦
𢺉	𫉨
𢺑	𢺧
𢺧	𢺑
𢺳	𪮳
𢺷	㩽
𢻌	𨸠
𢻗	敮
𢻼	𢼈
𢼎	𫾩
𢼚	𣢛
𢼣	𫾪
𢼦	𢼭
𢼧	𫾱
𢼩	𢼶
𢼲	𫾭
𢼳	𢼑
𢼹	𢽊
𢼾	𢽋
𢽃	𢽗
𢽍	𬆧
𢽕	𫾴
𢽖	𢽪
𢽜	𢽷
𢽢	𢽵
𢽣	𢽶
𢽥	𫾾
𢽦	㲁
𢽨	𪯏
𢽴	𢽚
𢾅	𢾖
𢾍	𢾕
𢾔	𥆸
𢾛	𣪢
𢾣	𢽫
𢾪	𢾦
𢿇	𫿡
𢿏	𢿖
𢿣	𫾤
𢿥	𫿓
𢿦	𢿽
𢿸	𥰡
𣀊	𣀊
𣀒	𢾸
𣀜	𣀡
𣀧	𩀼
𣀰	𣀱
𣀶	𣀹
𣀷	𫾲
𣀸	𣀺
𣁗	𢾋
𣁳	𦧌
𣁷	𣁻
𣂈	𦮜
𣄘	𣄤
𣄠	𣄡
𣄸	𬀥
𣅃	𣅁
𣅙	𣅘
𣅧	𣆀
𣆒	𣆭
𣆗	㬁
𣆚	𠕝
𣆨	𣇑
𣆳	𰖖
𣇢	𣊶
𣇳	𣈒
𣈍	𬁁
𣈔	𣈘
𣈡	𢻖
𣉩	𣇩
𣉪	𣊀
𣉱	𣊴
𣉹	𬁊
𣊁	𰖢
𣊓	𥊍
𣊘	𬵅
𣊭	𣊫
𣊸	𣊸
𣊿	𣋂
𣋋	𣈣
𣋎	𡴠
𣋞	𣉼
𣋴	𪊿
𣌮	𪰢
𣍚	𢆅
𣍦	𦙿
𣍸	𦝓
𣎄	𦜷
𣎅	𦝲
𣎎	𣎐
𣎓	𣎓
𣎛	𦠈
𣎳	汖
𣎵	朩
𣏃	𣏃
𣏅	𡉿
𣏕	𣏕
𣏖	㮳
𣏚	𰓅
𣏟	𣑼
𣐋	𭩤
𣐑	𣖲
𣑂	𣐰
𣑩	𭫎
𣑭	𣑭
𣑵	𥞰
𣒂	𣓱
𣒅	𣑆
𣒍	𬄋
𣓄	𣒽
𣓉	𣕹
𣓗	𣒪
𣓧	𣕏
𣔪	𣓽
𣔲	𣐒
𣔵	𣛳
𣔶	𬂦
𣔺	𣓍
𣔿	𰗘
𣕅	𣖏
𣕤	𬃷
𣖬	𰘒
𣖲	𣓄
𣖻	𨡬
𣖼	𣓓
𣖾	𣓂
𣗖	𣙏
𣗙	𬄐
𣘈	𪳔
𣘨	𢰜
𣘫	𣒱
𣘼	𣙅
𣙎	㭣
𣙤	𣚘
𣙰	𣚩
𣙿	𬃮
𣚁	𣚀
𣚜	𣞷
𣚟	𬄢
𣚣	𣚣
𣚯	𰙇
𣛕	𣡗
𣛣	𬂻
𣛹	𣜅
𣛺	𣒬
𣜄	𣠾
𣜜	杤
𣜢	𰘊
𣜬	𪳗
𣜰	𣟚
𣝍	𦼭
𣝑	𣟰
𣝕	𣘷
𣝜	𪓎
𣝞	𩏙
𣝡	𣞼
𣝬	𬄸
𣞁	㮠
𣞎	𬄱
𣞐	𰗚
𣞗	𣟑
𣞻	𣘓
𣟀	𣝘
𣟋	𣟯
𣟤	𣟓
𣟴	𣡬
𣟹	𥶠
𣟼	䵲
𣠇	𢺅
𣠩	𣞎
𣠲	𣑶
𣡡	𬅔
𣢁	𪴫
𣢂	𪴫
𣢉	𣢚
𣢑	𣢇
𣢛	𣤈
𣢧	䶾
𣣉	𪕆
𣣏	𣣤
𣣧	𰙐
𣣵	𪴴
𣣶	㰡
𣣹	𣣥
𣣿	𰙍
𣤋	𰙕
𣤕	𡂜
𣤚	燞
𣤢	𰹚
𣤨	𪴳
𣤴	𢨛
𣤿	𬶷
𣥊	𣥢
𣥎	𢆒
𣥐	𣥓
𣥔	𪰊
𣦧	𣦬
𣦼	𣦻
𣧂	𣧅
𣧄	𭗿
𣧌	𣧆
𣧍	𣧰
𣧏	𭣤
𣧟	𣧾
𣧡	𣧌
𣧥	㱝
𣧬	𣧔
𣧷	𬆔
𣧺	𣧱
𣨅	𣩗
𣨌	𧥧
𣨐	𣩋
𣨡	𣧭
𣨢	𣧪
𣩁	𣩂
𣩕	𬆙
𣪍	𣪍
𣪬	𤚼
𣪯	𢾮
𣫎	𣚯
𣫒	𫶲
𣫞	𣪻
𣫧	𠫌
𣫺	𣫺
𣫽	𬓻
𣬂	𣥥
𣬐	𣬔
𣬘	𣬗
𣬩	𰚑
𣬶	𣬷
𣭠	𣭄
𣭷	𰚘
𣭺	𣭽
𣭻	𣥡
𣮃	𣯂
𣮠	𭯜
𣮦	㲡
𣮻	𣮗
𣯅	𠫈
𣯐	𣮹
𣯚	㲮
𣯧	𣯯
𣯩	𣯣
𣯪	𢒩
𣯬	𣮡
𣯴	𣭤
𣯵	𣬴
𣰈	𣬠
𣰛	𰚱
𣰡	𣰣
𣰨	𬇄
𣰳	𣰴
𣰷	𰚵
𣰼	𰚶
𣱉	𰚸
𣱓	𦦛
𣲄	𠖮
𣲜	𪱶
𣲱	𤆩
𣲼	𣲼
𣳤	𣳄
𣳦	𪵻
𣴖	㳨
𣴣	焋
𣴨	𠗍
𣴷	𣶲
𣵀	涅
𣵷	𣢟
𣶒	𫂱
𣶥	𭱥
𣶬	㴠
𣶯	𰛉
𣷞	㴕
𣸈	𪷅
𣸊	𣸮
𣸒	𰜣
𣺈	𰜸
𣺖	𫞙
𣺭	𣺁
𣻏	𬇼
𣻒	𣻓
𣻛	湷
𣼵	𫉃
𣽂	𡙆
𣽍	𣾄
𣽏	𪶮
𣽔	𣻶
𣽕	𣿏
𣽞	𣽞
𣽟	𪶿
𣽦	𭒞
𣽭	𤀄
𣽺	𣻵
𣾎	𣾎
𣾞	𣽁
𣾷	㳢
𣿆	𣹋
𣿉	𣶫
𣿥	𣿧
𤀇	𬉯
𤀌	𭲔
𤀤	𤂳
𤀪	𬈱
𤁡	𫾘
𤁣	𣺽
𤁥	𣿢
𤁪	𬈾
𤁮	𰲉
𤁿	𰝪
𤂊	𤃮
𤃃	𭳐
𤃄	𡾎
𤃡	𪷿
𤃩	𤅷
𤃪	𤂴
𤃭	𤄩
𤃶	𧰥
𤄂	𤄾
𤄖	𭰏
𤄙	𰝞
𤄥	𣍒
𤄷	𪶒
𤄸	𤄼
𤄺	𤁻
𤅙	𬇬
𤅣	𤅚
𤅲	𤅠
𤅶	𣷷
𤅷	𰛻
𤅹	𪈯
𤆌	𤆆
𤆘	𪸎
𤆝	炇
𤆴	𫝅
𤇣	𤇓
𤇾	𫇦
𤈥	𤈑
𤈦	𤉂
𤈪	𪸬
𤉂	𰞫
𤉌	𤉉
𤉎	𪹃
𤉙	𤉅
𤉢	𬊟
𤉤	𤎨
𤊳	煅
𤋎	𪥗
𤌢	𤌪
𤌹	𣉙
𤍒	𤑗
𤍔	𫡃
𤍖	𬊗
𤍛	𤎬
𤍜	𰞷
𤎁	𤎾
𤎭	𠓮
𤎱	㷪
𤎲	𬴼
𤏢	𤎩
𤏱	𰱸
𤏸	𤏲
𤏻	𤍛
𤐀	𤒬
𤐛	𬊢
𤐧	𤎪
𤐨	𪸞
𤐴	𬊭
𤑃	𦡶
𤑉	𤑍
𤑍	𤊪
𤑨	𤑜
𤑳	𤎻
𤑵	𭶡
𤑿	𤒤
𤒎	𤊀
𤒓	𤒉
𤒘	𬊯
𤒞	𨐹
𤒯	𤍬
𤒻	𪹹
𤓓	𬊜
𤓩	𤊰
𤓾	𣁍
𤓿	𤓴
𤔂	𤓿
𤔎	𤫶
𤔔	𤔐
𤔣	𠭦
𤔨	𭶸
𤔪	𤔭
𤔱	𦦪
𤔲	𬋹
𤕟	𤕠
𤕾	𤗂
𤖆	𦎗
𤖖	𤗶
𤖘	𤗸
𤖱	𥞩
𤖴	𤗙
𤖼	𤖿
𤖽	𤖾
𤗁	𤖬
𤗏	𤖯
𤗳	𰠝
𤗺	𤖟
𤗽	𦼶
𤘀	𪺣
𤘠	𬌚
𤘡	𦧈
𤘦	𤙩
𤘫	𤘛
𤘵	𣅫
𤘹	𤘢
𤘾	𤙀
𤙝	𬩶
𤙣	𤙖
𤙼	𤚁
𤚖	𩮆
𤚥	𬼪
𤚫	𤛋
𤛉	𩎲
𤛑	𧴄
𤛛	𤛩
𤛠	𬌥
𤛣	𤚺
𤛮	𤙯
𤛲	𤛂
𤜃	𤜀
𤜆	𪺪
𤜐	𤛻
𤜙	㸳
𤜷	𤝃
𤝵	𤝶
𤝻	𧳁
𤞌	𤞮
𤞲	𤞙
𤟃	𤡞
𤟆	𠝨
𤟠	𤟕
𤟿	𤠊
𤠎	𤟺
𤠑	𤡼
𤠔	𰡐
𤠖	𤠬
𤠝	𬌬
𤠟	𤟬
𤠤	𤠛
𤠫	𤢂
𤠮	𪺸
𤡁	𤠨
𤡑	徱
𤡥	𤡦
𤡪	𤢩
𤡮	𤢅
𤢟	𤝢
𤢺	𭀂
𤢻	𢢐
𤣎	𰡢
𤣤	𬌴
𤣲	𤣭
𤣴	𰙝
𤣼	𰡱
𤤎	𪺛
𤤮	𤦪
𤥜	𤣻
𤥭	𰡰
𤥺	𤩆
𤦄	𡐜
𤧛	𪼀
𤧜	𤦄
𤨗	𤪇
𤩂	𫞧
𤩤	𣤦
𤪄	𤩃
𤪍	𤪆
𤪎	𤪰
𤪙	珎
𤪤	𪛞
𤪥	𬍜
𤪰	𤩤
𤪺	㻘
𤫉	𤫙
𤫣	瓛
𤫩	㻏
𤫱	𤬈
𤬁	𣜢
𤬅	𪼴
𤬓	𤬚
𤬝	𤬜
𤬩	𢦭
𤬾	𬎨
𤭢	𤬫
𤭴	𤭽
𤮎	𤮉
𤮙	𤮆
𤮜	𦉕
𤮦	𬎬
𤮱	𡓳
𤮾	𤮿
𤯍	𬓶
𤯒	𪐕
𤯔	𰆘
𤰁	𤯶
𤱅	𤱆
𤱏	𬏂
𤱓	𤰶
𤱛	𤱃
𤱢	𰐍
𤱧	𭻐
𤱨	𤲻
𤱾	𤰮
𤱿	𡻼
𤲓	𭻔
𤳀	𪽚
𤳞	𬏏
𤳤	𤳃
𤳽	𬏑
𤴀	𤳭
𤴍	𤴉
𤴦	𤴥
𤴱	𤵊
𤵛	𤷁
𤵭	𭼶
𤵻	𤵅
𤶀	㽱
𤶘	𪺞
𤶚	𬌂
𤷃	𪽭
𤷈	𤸏
𤷍	𬌋
𤷎	䏨
𤷗	𤺓
𤷙	𤹬
𤷣	𤸣
𤸀	𪽰
𤸄	瘝
𤸅	𤵤
𤸤	𤸐
𤸪	𤸞
𤸫	𤶧
𤸵	𤵗
𤸶	𤹲
𤺁	𤻯
𤺃	𤻁
𤺉	𰣦
𤺔	𪽴
𤺻	𦢿
𤻖	𤷒
𤻲	𬏤
𤻳	𢋧
𤼈	𰣫
𤽁	𤽆
𤽅	𤽕
𤽊	𤽏
𤽹	𤾁
𤾉	𰤓
𤾡	𤾡
𤾣	𤾷
𤾳	𤾭
𤾸	𤾸
𤿀	𤾶
𤿏	𤿒
𤿓	𤿻
𤿙	𠂱
𤿚	𥅗
𤿫	𭽦
𤿰	𤿬
𥀃	𥀄
𥀏	𥀇
𥀔	𢿇
𥀝	𥀸
𥀣	𬐓
𥀫	㿵
𥀬	𪠏
𥀰	𥀥
𥀲	𰤫
𥀻	𥀽
𥁄	𥁄
𥁍	𧖫
𥁕	𭽼
𥂈	𧗉
𥂸	𬐠
𥃟	𣫨
𥃪	𥄧
𥃲	𥃲
𥃳	𥃳
𥃵	𥃶
𥄍	𭨫
𥄎	𫿊
𥄑	𦔾
𥄓	𥄃
𥄖	𥄛
𥄘	𥄟
𥄙	𥄙
𥄳	𥄳
𥄶	𫵆
𥅘	䑐
𥅞	𪰜
𥅪	𰥧
𥆏	𥊱
𥆔	㫴
𥆛	𰥦
𥆝	𥇇
𥇌	𥉰
𥇎	𥌃
𥇑	䀶
𥇔	𬑇
𥇛	𥈜
𥇜	𥌲
𥈀	𥈏
𥈃	𥉡
𥈄	𥆇
𥈉	𥋂
𥈋	𥄷
𥈍	𥈫
𥈙	䀳
𥈩	𥈄
𥈾	𥄴
𥉉	𥉉
𥉍	𦞲
𥉫	𥉩
𥉰	𥈺
𥉴	𥋱
𥉶	𣊈
𥉸	𰥣
𥉻	䀙
𥉾	𩖇
𥉿	𥊋
𥊀	䀐
𥊇	𥂄
𥊊	𥆋
𥊝	𥅿
𥊢	𥊣
𥊬	䁒
𥊴	𥊁
𥋝	𰥭
𥋢	𥌪
𥋮	𥋯
𥌂	𥋬
𥌅	𣎩
𥌋	䑅
𥌚	𬑙
𥌜	𥋨
𥌯	𥍇
𥌼	𥋞
𥌾	𥊹
𥍆	𥍏
𥍉	𥆍
𥍊	𩁰
𥍫	𥎇
𥍮	𥎌
𥍻	䤷
𥎂	𥍾
𥎊	𥎚
𥎓	𥎔
𥎕	𢨌
𥎘	𥐎
𥎝	𥎞
𥎰	𥎸
𥎺	𰦗
𥏝	𪿊
𥐝	𥐝
𥐞	𡵀
𥐾	𪿕
𥑱	𥑙
𥒜	砯
𥒞	𬒌
𥓈	𥑾
𥓖	𥔟
𥓫	𥓬
𥔂	𮀲
𥔡	𥔜
𥔮	𮀸
𥕉	𥕒
𥕡	𮀐
𥕥	𥐰
𥕧	𬒛
𥕲	𥕳
𥕶	𰧣
𥖄	𥗢
𥖅	𥐯
𥖏	𮀪
𥖩	𬒊
𥖪	𮀺
𥖫	𥗣
𥖲	𪿞
𥗀	𡫱
𥗇	𪿵
𥗭	𥗱
𥗴	𬒓
𥗹	𰧈
𥗽	𬒗
𥗿	𥘁
𥘃	𮀡
𥘇	𥘈
𥙁	𥙇
𥙨	𮁳
𥙫	𥟁
𥚚	𥚚
𥚩	𥚝
𥛜	𧇘
𥛝	䙜
𥛞	𥛪
𥜐	𫀓
𥜰	𫀌
𥝂	𥝉
𥝇	𥝆
𥝋	𥍈
𥝖	𥝬
𥝫	䄵
𥞛	𮃄
𥞜	𥞢
𥞧	𥞟
𥞴	𥟾
𥞵	𥞦
𥞼	𥠿
𥟔	𥠝
𥠌	𥠠
𥠗	𫞸
𥠷	𥢋
𥡟	𥠔
𥡠	𥢡
𥡤	𥡱
𥡥	𮃐
𥡪	𥤌
𥢅	𥢆
𥢊	𬓱
𥢢	䅪
𥢶	𫞷
𥢷	𫀮
𥣬	𥤐
𥣮	𥠈
𥣻	𦼖
𥤚	𪺋
𥤞	𥢴
𥥉	𬔈
𥥗	𥦣
𥥥	𥦈
𥥸	𥧣
𥥼	𥥼
𥧐	𥨏
𥧞	𬔊
𥨂	𪧤
𥨐	𥧂
𥨕	𥧶
𥨝	𥨡
𥨥	𥨗
𥩀	𰩗
𥩈	𫞺
𥩱	𥩦
𥩲	䇋
𥪁	𫷘
𥪂	𥩺
𥪋	𥪬
𥪯	𥩼
𥫔	贛
𥫕	𩑇
𥫝	𢎉
𥫱	𥫬
𥫳	𬔭
𥬈	𬔰
𥬎	𬔴
𥬕	𰩱
𥬲	𥬸
𥭓	𥭀
𥭭	𥮭
𥮉	𫧓
𥮘	𥵮
𥮜	𥭫
𥮥	𥯻
𥮫	𥮫
𥯘	𥭕
𥯟	𥯠
𥯤	𫁳
𥯩	𦳵
𥯬	𥱇
𥰅	𥲂
𥰠	𥲬
𥰥	𦩶
𥰦	𥯼
𥰬	𥲾
𥰭	𥭯
𥰮	𥰯
𥰶	𥯾
𥱷	𥳹
𥱸	𬔯
𥲀	𥲀
𥲆	𥶥
𥲖	𫂜
𥲣	𥲨
𥲤	𥳁
𥲧	䉫
𥳊	𬔹
𥳏	𬔸
𥳒	𥳷
𥳔	𥶴
𥳰	𫂫
𥳲	𥲗
𥳾	𥴴
𥳿	𥱃
𥴧	𥱿
𥴨	𫂖
𥴩	𥵰
𥴮	𥴾
𥴼	𫁺
𥵊	𥭉
𥵝	𬕬
𥵨	𥵑
𥶅	𥵄
𥶈	𥲝
𥶉	𬲙
𥶎	𥷟
𥶛	䈕
𥶶	𥽧
𥶹	𥴰
𥶽	𫁱
𥶾	𥷗
𥷕	𥶺
𥷩	䕹
𥸂	𥸇
𥸡	𥸜
𥸥	𥸦
𥸪	𬖌
𥸸	𨕜
𥹇	𥸰
𥹋	𬖎
𥹷	𮇶
𥺼	𮇔
𥻩	𥺥
𥻵	𬖞
𥻷	𥺰
𥼁	𥡢
𥼊	𥽅
𥼋	𥼅
𥼽	𥹥
𥽏	𥼿
𥽣	𫟀
𥽭	𬖺
𥽳	𦗶
𥽽	𫧷
𥾐	𢍽
𥾝	𬘔
𥾣	𥿔
𥾩	𥿅
𥾯	𫄝
𥿄	𥾬
𥿊	𦈈
𥿋	𦅳
𥿽	𦀀
𦀎	𮉥
𦀒	𠕮
𦀖	𫄦
𦀘	𦄕
𦀤	𦦆
𦁕	𰬦
𦁚	𦂣
𦁤	𦁇
𦁧	𰬨
𦁵	𦀆
𦂅	𦈒
𦂋	𬘸
𦂗	䌃
𦂢	𦂖
𦃄	𦈗
𦃇	𦁲
𦃏	𰫢
𦃒	𬘼
𦃙	㬧
𦃟	𦂞
𦃩	𫄯
𦃫	𬗚
𦄑	𦇀
𦄧	𬘿
𦄽	𦂘
𦅃	䌭
𦅇	𫄪
𦅈	𫄵
𦅋	𬙃
𦅷	𬙅
𦅽	𢍣
𦆀	𦅗
𦆈	𰬹
𦆞	䌗
𦆪	𮉑
𦆭	𦅜
𦆲	𫟇
𦆹	𬗔
𦆾	𦈁
𦇎	𰭁
𦇕	𫄒
𦇚	𦇚
𦇛	𰬼
𦇧	𦆢
𦈾	𦉋
𦉇	𦉇
𦉐	𤮬
𦉔	𤕆
𦉫	⺵
𦉴	𦉲
𦉾	𦉺
𦊔	𠉁
𦊜	𦊘
𦊾	𦋑
𦋅	𣫴
𦋊	𬙡
𦋐	𫅃
𦋙	𦋙
𦋥	𦋩
𦋩	𦊹
𦌁	𦌑
𦌊	𦌉
𦌷	𦉷
𦍅	𦍂
𦍆	𬙫
𦍕	𤞢
𦍣	𦍓
𦍹	𦍽
𦍼	𦍘
𦎇	𦎜
𦎌	𤚥
𦎦	𦏃
𦎧	𠆆
𦎯	𦎼
𦎱	𦎩
𦎸	𦏙
𦎹	𰭚
𦏆	𦍻
𦏑	𰭗
𦏻	𦏴
𦐍	𦐋
𦐣	𦐨
𦐲	𣇶
𦐴	𦑆
𦐽	𦑉
𦑏	𦐰
𦑞	𦑭
𦑴	𬚆
𦑶	𩀚
𦒀	𫅥
𦒄	𦑓
𦒎	𦑐
𦒐	𦒚
𦒑	𦒔
𦒜	𩙼
𦒧	𦑱
𦒯	𦒫
𦒺	𡄒
𦒻	𦒾
𦓂	𦓁
𦓥	𨛙
𦓷	𧂬
𦔌	䅲
𦔓	𦔟
𦔖	𫅼
𦔣	𦔣
𦔯	𦔰
𦔷	𰭳
𦔼	𨈙
𦖈	𦗆
𦖉	𦕋
𦖝	𦖨
𦖟	𫆒
𦖥	𰆉
𦖬	𦗃
𦖿	𦗧
𦗋	𨉷
𦗐	𦗍
𦗒	𦘅
𦗓	䎼
𦗕	𬸽
𦗴	𦡁
𦘒	帇
𦘧	𡳒
𦘩	𦘲
𦘴	𦙅
𦙀	𦙹
𦙙	𣍤
𦙜	𦛐
𦙤	𬚱
𦙦	𬚲
𦙮	𣍥
𦙴	𬚶
𦙽	𦚻
𦚑	𡱎
𦚗	𬚴
𦚘	𦚮
𦚦	𦜎
𦚩	𬚹
𦚷	𦚶
𦚾	𫣍
𦛖	𧶋
𦛠	𦞆
𦛡	𥇃
𦜆	𰯀
𦜒	𪱠
𦜖	𬁺
𦜯	𤊯
𦝆	𦝍
𦝔	𦛪
𦝝	𰯘
𦝦	𦜤
𦞁	𩹯
𦞈	𦞕
𦞌	𣎄
𦞙	𦞱
𦞚	𦚡
𦞛	𬁸
𦞡	䐥
𦞢	𦡵
𦞤	𦛛
𦞧	𦞧
𦟀	𮌩
𦟐	𬁳
𦟞	𦞵
𦟟	𦣆
𦟤	𦪋
𦟰	𦟚
𦟼	𫆝
𦠄	𦢍
𦠇	𰯐
𦠎	𰯚
𦠖	𦢭
𦠯	𬚿
𦡂	𦡦
𦡌	𦢯
𦡕	𰯍
𦡖	𰗆
𦡝	𫆫
𦡫	肞
𦡭	𦡌
𦡱	𰯪
𦡶	𰯂
𦡹	䯥
𦡼	𦢇
𦢈	𣍨
𦢊	𦣃
𦢡	𦢢
𦢤	𨣵
𦢨	𰯤
𦢩	䐹
𦢬	𧂿
𦣇	𬂂
𦣊	𦣎
𦣎	𦟗
𦣞	𦣝
𦣸	𥃢
𦣾	𤽅
𦤦	𦤪
𦤧	𦝀
𦤬	𦟈
𦤿	𦥈
𦥐	𧤡
𦥚	𦥤
𦥯	𰃮
𦥻	𦦇
𦦗	栄
𦦣	𣋁
𦧚	𬜅
𦧺	𫇘
𦨄	𦨃
𦨇	𦨏
𦨈	𦨊
𦨜	𦨒
𦨣	𦩍
𦨦	𦩪
𦩈	𦩉
𦩘	𮎑
𦩝	𦪒
𦩣	𦪈
𦩨	𦩦
𦩴	𦪍
𦩼	熕
𦪣	𦪢
𦪬	𦩥
𦪭	𬜔
𦫳	𠁥
𦬂	𦬍
𦬅	𦬲
𦬘	𦰠
𦬞	𰇐
𦬸	𦸇
𦬼	𦬼
𦭜	𧁤
𦭝	𦭾
𦭻	𫇰
𦮶	㖴
𦮼	𦯡
𦮾	𦸖
𦯈	𦵲
𦯑	𦳱
𦯒	䒢
𦯼	𦰊
𦰚	𦮮
𦰡	𦰢
𦰪	𦳸
𦰿	𠌅
𦱄	𦻨
𦱌	𫇪
𦱡	𠭞
𦱧	𡼘
𦱩	䓧
𦱭	𦰙
𦲝	𦰓
𦲰	𦯟
𦳋	𦬿
𦳓	𦽏
𦳕	𦳕
𦳝	𰰢
𦳢	𦴗
𦳫	𦰻
𦳭	𫈡
𦴆	𦰶
𦵕	𬝖
𦵦	𧀝
𦵷	𦾼
𦵸	𧀙
𦶀	𦼇
𦶃	𦯛
𦶆	𬜺
𦶎	𦹬
𦶙	𣘇
𦶚	𦽽
𦷟	𣜎
𦸂	𤀻
𦸅	𦶲
𦸐	𦽂
𦸓	𦮇
𦸔	𦶌
𦸙	𦬓
𦸷	𬝊
𦺊	𦼍
𦺔	䒝
𦺞	𦱕
𦺣	𰱝
𦺩	𦻝
𦺪	𦸸
𦺶	𦸠
𦻀	𧀖
𦼉	𧂴
𦼏	𦸥
𦼣	𦻞
𦼩	𦻅
𦼪	𧃺
𦼬	𦼬
𦼷	𦿓
𦼹	𫉿
𦽄	𦽞
𦽇	𦡐
𦽊	𧃭
𦽎	𦼋
𦽒	𬝠
𦽓	𦺺
𦽕	𧀀
𦽽	𬞦
𦾟	𦶻
𦾨	𦽵
𦾪	𬞯
𦾮	𧁀
𦾱	𦾱
𦾶	𬞋
𦾽	𦿚
𦿁	𦽪
𦿇	𨟂
𦿭	𤂙
𧀄	𦿄
𧀜	𬞨
𧀠	𦼙
𧀨	𦼤
𧀬	𦸝
𧀲	𮆬
𧀹	𬩦
𧁀	𦼮
𧁏	𧀶
𧁾	𦭯
𧂅	𬞣
𧂆	𧁴
𧂣	𦾫
𧂲	𧃓
𧃒	𧃒
𧃓	𧃈
𧃭	𧄋
𧃱	𦷠
𧃳	𫉵
𧃷	𬞲
𧃹	𣟦
𧃽	𰱊
𧄔	𧂤
𧄠	𧅟
𧄽	𮒟
𧅍	𧁁
𧅘	𧂦
𧅛	𧆀
𧅤	𬝄
𧆄	𬟥
𧆉	𰫻
𧆢	𧆮
𧆥	𢈤
𧆨	𤴅
𧆼	𧈆
𧇃	𧇥
𧇠	𡰐
𧇥	𧇨
𧇰	𧆯
𧈑	𧈎
𧈔	𧈘
𧈜	𩦶
𧈦	𧊪
𧈹	𡘗
𧉀	𧉘
𧉁	𧐆
𧊒	𬅟
𧊚	䳋
𧊧	𬠹
𧊶	𧊱
𧋥	𧋩
𧌄	𧍬
𧌥	𧎈
𧌽	𧒀
𧍇	𩸲
𧍕	䖼
𧍠	𧉰
𧍰	𧑟
𧍲	𧍻
𧍴	𬟾
𧍶	𧊐
𧎢	𧈩
𧎦	𧏥
𧎨	𫋢
𧎫	𧑀
𧎯	蚗
𧎲	𧐞
𧏊	𧏊
𧏜	𧏃
𧏻	𬠃
𧏿	𮕆
𧐋	𧐣
𧐐	𰳁
𧐒	𧐁
𧐔	䗑
𧐖	𧍴
𧐱	𬟺
𧑀	𧑳
𧑎	𧎃
𧑗	𧒫
𧑚	䗙
𧑫	𧑁
𧒀	𧌽
𧒌	𧒍
𧒖	𰲺
𧒯	𫊹
𧒽	𧒜
𧓦	𫋟
𧓱	𧒛
𧓽	𢋭
𧔃	𧔲
𧔄	𧓚
𧔅	𮕍
𧔏	𧔩
𧔥	𧒭
𧔽	𧔸
𧕃	𧓰
𧕆	𧔠
𧕌	𤴂
𧕛	𧔳
𧖇	䗸
𧖐	𧒋
𧖦	𬠱
𧖰	𧖱
𧗿	𧗵
𧘗	𧙴
𧘢	𧘛
𧘨	𧘩
𧙀	𬡏
𧙁	䘣
𧙃	𧙑
𧙟	𫀍
𧙤	𬡖
𧙥	𫀈
𧚎	𧛳
𧚮	𬡡
𧛑	𡫚
𧛞	𧛫
𧛟	𮂇
𧛼	𥛖
𧛾	𧜡
𧜂	𬡔
𧜉	𮪸
𧜕	𧘓
𧜗	䘞
𧜵	䙊
𧝄	𧞳
𧝊	𧙢
𧝑	𧝣
𧝞	䘛
𧝸	𩮆
𧞀	𧜶
𧞁	䙣
𧞅	𰳻
𧞐	𧞮
𧞓	𪗋
𧞕	𧞙
𧞣	𰳹
𧞫	𫌋
𧞬	𧞩
𧞶	𬡦
𧟀	𧝧
𧟌	𬡠
𧟙	䙥
𧟠	𧟡
𧟽	𥷾
𧠈	𬢇
𧠊	㝟
𧠟	𧠠
𧠥	𬢉
𧠰	𧠬
𧠵	𬢍
𧡉	𧡕
𧡍	𬢈
𧡕	𧡉
𧡪	𬢏
𧡴	𫌫
𧢃	𰴚
𧢄	𫌬
𧢍	𬢓
𧢞	𧡌
𧢦	𧢫
𧢭	𧢩
𧢰	𧢯
𧢲	⻇
𧢼	𧣉
𧢾	𧣐
𧣁	𧣍
𧣒	𧣻
𧣖	𧣟
𧣪	𤙜
𧣭	𧤷
𧣴	𬢕
𧣼	𧣱
𧤅	𤁭
𧤒	𧤜
𧤕	𧣮
𧤗	𧤬
𧤽	𰴦
𧥂	𦠧
𧥓	𧥒
𧥖	𧥗
𧥣	𬣚
𧥶	䚾
𧥸	䚿
𧥹	𧧽
𧥺	𬣝
𧥼	𧬞
𧥿	𣵧
𧦤	𧦲
𧦭	𬣢
𧦹	𮘅
𧧃	𬛥
𧧝	𬣨
𧧨	𧧇
𧧭	𬣺
𧧺	𧫔
𧧻	𧩳
𧨄	𧥦
𧨊	𬣶
𧨘	𮘉
𧨝	𰵪
𧨱	𧧫
𧨳	𰵳
𧨾	𬤂
𧩕	𫍭
𧩙	䜥
𧩣	𧧣
𧩦	𬤅
𧩧	𬤏
𧩨	𧩩
𧩱	𧫮
𧩼	𫍶
𧪜	𧩝
𧪞	𬤒
𧪡	𬤓
𧪤	𮘭
𧪦	𬤕
𧪪	𬤔
𧪫	𠹇
𧪮	𰵻
𧫙	𫶪
𧫚	𬤈
𧫝	𫍺
𧫱	𬢼
𧫷	𧫣
𧬅	𬤜
𧬇	𬤞
𧬤	𫍼
𧬧	𧬝
𧬨	𬣪
𧬪	𬤖
𧬮	𬤧
𧬯	𰶋
𧬻	𬣵
𧭈	𫍾
𧭊	𡁏
𧭟	𧭋
𧭣	𧭕
𧭤	𡅜
𧭪	𣤬
𧭮	𧭇
𧮆	𬤚
𧮇	𬣴
𧮈	𬤯
𧮬	𧮭
𧮼	𬽘
𧯠	𧯤
𧯥	𰶞
𧯦	𧰌
𧯩	𪽧
𧯫	𢹑
𧯱	𰒪
𧯽	𤲊
𧰆	𬤷
𧰎	鿲
𧰓	𧰛
𧰠	𤮵
𧰨	㐺
𧰫	𢽴
𧰲	𧰳
𧰿	𧰸
𧱐	㹲
𧱫	䝐
𧱭	𬤼
𧱴	猽
𧱻	𰶨
𧲍	𧲎
𧲕	𫲜
𧲙	𰶰
𧲨	𧲨
𧳂	𧲶
𧳄	𧲳
𧳛	𧱙
𧳨	㑱
𧳼	𧴉
𧴂	𧴟
𧴄	𧱿
𧴎	𧴕
𧴖	𧴑
𧴠	𤡫
𧴭	𧵏
𧵊	𬥴
𧵮	𬥑
𧵳	䞌
𧶄	𬥷
𧶇	𫎘
𧶊	𧶀
𧶔	𧹓
𧶟	𬥹
𧶢	𫸳
𧶧	䞎
𧶲	𬥼
𧶵	𧷊
𧶷	歵
𧶺	𧷭
𧶽	𰷟
𧷛	𰷨
𧷧	𧷄
𧸅	𧹀
𧸇	𧷗
𧸘	𫎨
𧸦	𬥾
𧸫	𫬙
𧸿	𧸹
𧹈	𪥠
𧹞	𤿜
𧹽	𧹶
𧺙	𧺖
𧺢	䟝
𧺯	﨣
𧻘	𨀦
𧻙	𧼟
𧻸	𨒧
𧼏	𧺻
𧼒	𧽡
𧼖	𰷹
𧼪	𨂰
𧼮	𬦅
𧼯	𧼯
𧽇	𧽈
𧽍	𰷻
𧽏	𧼭
𧽒	䠗
𧽖	𰷽
𧽢	𬦆
𧽮	𬩰
𧽯	𫎸
𧽸	𧼞
𧽻	蹫
𧾆	𧽹
𧾓	𧾁
𧾥	𰷸
𧾨	𢖘
𧾩	𧾝
𧾰	𨙒
𧾱	䞤
𧿅	𧿎
𧿓	𧿯
𧿳	䞞
𧿼	踻
𨀍	𤰉
𨀥	𰸏
𨀧	𰸧
𨀨	𫏎
𨁀	𠐃
𨁁	𢕐
𨁂	𬦯
𨂐	𫏌
𨂜	𨂑
𨂝	𨃱
𨂠	𨅑
𨂣	𨄝
𨂭	𣥽
𨃗	𨆐
𨃚	𨅞
𨃜	𬦹
𨃣	𢔳
𨃥	𨃮
𨄉	𰸎
𨄍	𨄤
𨄰	𬦵
𨅊	𨇂
𨅎	𨄒
𨅔	𨅕
𨅫	𨇞
𨆅	𬦫
𨆉	𮛗
𨆊	𨅘
𨆏	䠔
𨆨	𫏩
𨆪	𫏕
𨆬	𮛎
𨆱	𬦴
𨇁	𧿈
𨇆	䠭
𨇍	𬧑
𨇖	𦢛
𨇗	𬦣
𨇣	𬦾
𨇤	𫏨
𨇩	𰸤
𨇰	𫏞
𨇼	𨊟
𨇽	𫏑
𨈀	𬧚
𨈆	𬧛
𨈇	𨇣
𨈊	𨂺
𨈌	𨄄
𨈓	𨈣
𨈫	𦙴
𨉖	𰿰
𨉹	𬧩
𨊢	𨊪
𨊰	䢀
𨊱	𫏲
𨊹	𰹻
𨊻	𨐆
𨊼	𨌉
𨋁	𬨃
𨋕	𨌞
𨋚	𬨅
𨋛	𨍠
𨋮	𰺆
𨌄	𬨋
𨌈	𫐍
𨌞	𨍖
𨌥	𨏟
𨌴	𨋱
𨍏	𰺕
𨍐	𬨏
𨍒	𰹾
𨍯	𨋧
𨍰	𫐔
𨍱	𰹛
𨍸	𰹤
𨍹	𬨐
𨍿	𨍺
𨎋	𨎖
𨎌	𫐋
𨎦	𨎀
𨎧	䧛
𨎪	𰺚
𨎮	𨐉
𨎷	𰹪
𨏊	𨍒
𨏔	𰺌
𨏠	𨐇
𨏤	𮝭
𨏪	𨏓
𨏳	𰹠
𨏴	𨍝
𨐀	𨏽
𨐔	𨐕
𨐖	𨐘
𨐡	𨐟
𨐨	𨐢
𨐩	𰺫
𨐶	𰺨
𨑊	𫯒
𨑑	𨑟
𨑗	𬅸
𨑤	𬨞
𨑥	𪴵
𨑨	𣅄
𨑩	𨒝
𨑳	𨓏
𨒆	𨑻
𨒈	𫵙
𨒌	𢌛
𨒞	𫹔
𨒪	𬅼
𨓰	𨘉
𨓲	𨔃
𨔙	𨕎
𨔝	𰻈
𨔦	𫹙
𨖀	𨔢
𨖋	𮞨
𨖍	𬨹
𨖏	𨗋
𨖛	𨖜
𨖷	𥯦
𨖼	𨖙
𨗒	𨗒
𨗭	𨗭
𨗾	𬨫
𨘂	𨘮
𨘉	𨘟
𨘌	𬩎
𨘓	𧼾
𨘕	𪴿
𨘴	𨙐
𨘺	𨙃
𨘼	𰹨
𨙂	𨙣
𨙎	𨔯
𨙔	𨙦
𨙭	𫭘
𨙷	𨚢
𨚖	𨝳
𨚳	𨛞
𨚵	𨛚
𨛋	䧉
𨛜	𫮳
𨛤	𨛛
𨛳	䣢
𨜒	𨜣
𨜓	𨜭
𨜱	𨝃
𨜴	𨜨
𨜿	𨝡
𨝋	𨝠
𨝌	𨝝
𨝔	𨟃
𨝵	𰻼
𨞋	𩮆
𨞚	𨞞
𨞨	𨝕
𨞪	𫜷
𨞺	𫟫
𨞼	𨟔
𨟄	𨟅
𨟊	𫟬
𨟌	𨟈
𨟏	𨞴
𨟑	𨟟
𨟠	䣤
𨟴	酳
𨟶	䣬
𨠋	𮠜
𨠕	𨠝
𨡤	𨠬
𨡭	𥎈
𨡴	𨣆
𨡸	𨢕
𨢌	𨣷
𨢍	𨢳
𨢎	𨣯
𨢐	𧤞
𨢦	𥰾
𨢺	𨡦
𨢿	𨡙
𨣃	𰼋
𨣄	𧠁
𨣉	𬪫
𨣍	𨢔
𨣚	𨣁
𨣞	𨟳
𨣨	𰼏
𨤡	𬪺
𨥍	𨥢
𨥏	𤤎
𨥓	𨥔
𨥔	𨥓
𨥙	𰽟
𨥛	𨱀
𨥜	𬬴
𨥟	𫓫
𨥭	銢
𨥺	𬭂
𨦂	𨰋
𨦄	𨧌
𨦅	𨦾
𨦖	𨧇
𨦡	𰽽
𨦫	䦀
𨦱	𰾊
𨦺	𫒉
𨧀	𬭊
𨧐	𰾇
𨧚	𬭐
𨧜	䦁
𨧨	𨮱
𨧫	𬭑
𨧰	𫟽
𨧱	𨱊
𨨁	𨨀
𨨏	𬭛
𨨚	𨧛
𨨝	𬭘
𨨢	𫓿
𨨭	𨧾
𨨯	𬭟
𨨳	𨩰
𨩒	𨩓
𨩨	𬭠
𨩰	𫟾
𨩾	𨦤
𨪅	𬇃
𨪋	𰾨
𨪕	𫓮
𨪗	𨬎
𨪵	𬭧
𨫀	𬭫
𨫒	𨱐
𨫗	𨫷
𨫤	𨯁
𨫲	𬫝
𨫼	𰾧
𨬂	𬭱
𨬑	𨯱
𨬒	𰾳
𨬕	𰾵
𨬖	𫔏
𨬚	𨰛
𨬛	𧅒
𨬞	𬬶
𨬠	𮣚
𨬹	𨬸
𨭃	𬭷
𨭆	𬭶
𨭊	𬭒
𨭌	𬭵
𨭎	𬭳
𨭐	𬭙
𨭗	𬭇
𨭛	𰾿
𨭥	𬬼
𨭸	𫔐
𨮁	𰾺
𨮂	𨱕
𨮃	𠨣
𨮅	𬭹
𨮒	𨯠
𨮢	𰼹
𨮰	𬭾
𨮳	𫔒
𨮻	𬫭
𨯅	䥿
𨯗	𮢽
𨯟	𫔓
𨯤	𨭞
𨯧	𨬪
𨯰	𫒤
𨯵	𬮀
𨯻	𬫟
𨯿	𰿀
𨰃	𫔉
𨰋	𫓳
𨰚	𨥖
𨰥	𫔕
𨰦	𫒭
𨰭	𬮃
𨰰	𨰦
𨰵	𬬇
𨰷	𬮂
𨱒	𨫾
𨱥	𰿖
𨱵	𨱶
𨲀	𨱺
𨲠	𩬡
𨲬	𩮼
𨲭	𬮄
𨲳	𫔖
𨲵	𨲷
𨳁	𨳅
𨳐	𰿧
𨳑	𨸁
𨳒	𮤭
𨳕	𨸀
𨳙	𮤯
𨳨	𬮜
𨳳	𢨸
𨳷	𨴥
𨳸	𰿭
𨳿	𬮡
𨴑	𬮣
𨴗	𨸅
𨴘	𨴌
𨴤	𬮧
𨴫	𫼍
𨴹	𫔲
𨵆	𬮩
𨵌	𬮰
𨵗	𬮯
𨵢	𨶠
𨵦	𰿵
𨵬	𬮵
𨵷	𨵷
𨵸	𨸇
𨶀	𨸉
𨶏	𨸊
𨶑	𰿸
𨶪	𨶟
𨶮	𨸌
𨶰	𰿹
𨶲	𨸋
𨶻	𬮸
𨶿	𬮹
𨷈	𬮙
𨷓	𨷳
𨷔	𨵮
𨷚	𱆉
𨷰	𨷏
𨷲	𨸎
𨷴	𨶉
𨷹	𨷒
𨷻	𫔱
𨸊	𨴸
𨸔	𨸒
𨸕	𬩴
𨸙	𨛗
𨸮	𱀄
𨸰	㘲
𨹌	𨛇
𨹜	𨻉
𨹸	䧂
𨹺	𨺅
𨺀	𠃆
𨺂	𱀩
𨺍	𨻚
𨺣	𨺽
𨻈	𨻨
𨻶	𡮱
𨻼	𨻀
𨼊	𨽬
𨼋	𱀭
𨼍	䧫
𨼐	𱀱
𨼳	𫔽
𨽍	𨽤
𨽏	𮤾
𨾬	𨾭
𨾭	𨾬
𨿐	䧽
𨿫	𱁊
𩀨	𫕚
𩁰	𧃼
𩂂	𩂚
𩂃	𩂝
𩂆	雬
𩂞	𮦍
𩂨	䨛
𩂴	𩂺
𩃙	𩅔
𩃱	𩃰
𩃸	𠄴
𩃾	𩄁
𩄏	𩂑
𩄠	𩄚
𩄪	𩅊
𩄮	𨘍
𩅀	𩅱
𩅅	𩅅
𩅗	𠍢
𩅙	𫕨
𩅦	𱁞
𩅽	𩇀
𩅾	𫡶
𩆊	𤸩
𩆒	𩆻
𩆺	𬰕
𩆼	𤅫
𩇉	𮦚
𩈀	𩇾
𩈇	𩈄
𩈑	𩈝
𩈕	𩈛
𩈚	𩈚
𩈣	𩈖
𩈥	𩓀
𩈫	𨠹
𩈵	𥂭
𩈽	𩈾
𩉍	𬰣
𩉗	𩉘
𩉘	𩉗
𩉙	𬰡
𩉧	𩊩
𩉬	𩉶
𩉺	𩉻
𩊅	𩋶
𩊜	𩎫
𩊝	𩊞
𩊿	𣊣
𩋃	𠤸
𩋄	𩌄
𩋈	𩊼
𩋊	𨌧
𩋎	𡳼
𩋝	𩍀
𩋢	𩋫
𩋥	𫖋
𩋬	𱁱
𩋰	𬰤
𩌍	䩡
𩌏	䪙
𩌑	䩩
𩌩	𩏘
𩌪	𩍾
𩌭	𩍪
𩌲	𩌙
𩍅	𩊗
𩍊	𩍋
𩍋	𩍊
𩍜	𱁳
𩍥	𪎱
𩍬	𩌁
𩎒	𬰱
𩎕	𱂃
𩎖	𫖑
𩎛	𩎡
𩎟	𱂄
𩎠	𬰴
𩎢	𩏾
𩎷	𩎭
𩎹	𩏟
𩏂	𫖓
𩏉	𠆎
𩏌	𬰵
𩏐	𩳷
𩏠	𫖖
𩏪	𩏽
𩏴	𬰸
𩏶	𩏸
𩐭	𩖲
𩐯	𩐲
𩐵	𩐹
𩑊	𩇄
𩑒	𱂠
𩑓	𩑏
𩑗	𩑑
𩑞	𩑫
𩑡	𱂡
𩑰	𩒢
𩑵	䫘
𩑿	𩒋
𩒀	𩒈
𩒎	𫖭
𩒖	𩒖
𩒚	𩓍
𩒜	𬱡
𩒝	𬱝
𩒯	𢋞
𩒰	𧶕
𩒲	𬱤
𩒴	𩓊
𩒼	𬱥
𩒾	䫓
𩓂	䫢
𩓋	𩓕
𩓝	𮨏
𩓣	𩖕
𩓩	𫡷
𩓸	𬱧
𩓹	𬱨
𩓽	𩒱
𩔇	𱂳
𩔑	𫖷
𩔳	𫖴
𩔴	𩪉
𩔹	𩔾
𩕆	𩕉
𩕰	𬱲
𩕳	𩕋
𩖁	𬺂
𩖊	㾉
𩖛	𩖜
𩖣	𩖰
𩖰	𫠇
𩖴	𱂾
𩖷	𠘼
𩖿	𬱺
𩗀	𩙦
𩗉	𩗞
𩗓	𫗈
𩗘	𩘂
𩗛	𱃛
𩗢	𩖻
𩗧	𱃂
𩗫	𩘙
𩗬	𩗖
𩗴	𫗉
𩘀	𩙩
𩘁	𩗬
𩘅	𩘗
𩘇	𩙛
𩘋	𩗇
𩘏	𱃇
𩘑	𩘕
𩘝	𩙭
𩘪	𬲄
𩘮	𱃋
𩘳	𩘤
𩘷	𱃍
𩘹	𩙨
𩘺	𩙬
𩘼	𩙄
𩙈	𩙰
𩙒	𱃐
𩙛	𩙓
𩙜	𱃑
𩙝	𱃒
𩚅	𬲥
𩚖	𩚒
𩚛	𩟿
𩚥	𩠀
𩚩	𫗡
𩚯	𩛐
𩚱	𩛯
𩚵	𩠁
𩛆	𩠂
𩛊	𩛕
𩛓	𨑏
𩛞	𬲺
𩛡	𫗨
𩛥	𬩆
𩛨	𣨆
𩛲	𬲹
𩛻	𡳋
𩜁	𩝘
𩜇	𩠉
𩜌	𩚴
𩜍	𢘐
𩜠	𬲿
𩜥	𩜤
𩜦	𩠆
𩜫	𩛸
𩜰	𬳃
𩜳	𩛤
𩜵	𩠊
𩜶	𱄁
𩝃	𫯉
𩝊	𩛶
𩝑	𬳇
𩝔	𩠋
𩝠	𬳌
𩝡	𬳈
𩝣	𬳉
𩝧	𱄅
𩝮	𬴺
𩝸	𩝜
𩝽	𫗳
𩞀	𩞼
𩞁	𫗗
𩞃	𬲰
𩞄	𩠎
𩞉	𬳐
𩞘	𬳏
𩞬	𬳒
𩞯	䭪
𩞰	𩟐
𩟀	𬳓
𩟂	𬲸
𩟉	𩜩
𩟗	𫗚
𩟘	𮩙
𩟙	𩟦
𩟟	𩟣
𩟠	𬳔
𩟣	𩟤
𩟭	𪎁
𩠐	⻡
𩠴	𩠠
𩠹	𫵐
𩡌	𩡐
𩡏	𨟝
𩡓	𦒥
𩡣	𩡖
𩡦	𩡥
𩡧	𩡪
𩡱	𩢙
𩡺	𩧦
𩢍	𬳷
𩢑	𩢭
𩢛	𩦞
𩢮	䮌
𩢰	𱅎
𩢲	𬳺
𩢴	𩧵
𩢷	𱄚
𩢸	𩧳
𩢼	𬳻
𩢽	𩢗
𩢿	𩣜
𩣋	𬳼
𩣏	𩧶
𩣑	䯃
𩣔	𬳹
𩣮	𩣦
𩣵	𩧻
𩣸	䧞
𩣹	𩤓
𩣺	𩧼
𩤊	𩧩
𩤏	𩣰
𩤘	𩣃
𩤙	𩨆
𩤡	𱄨
𩤲	𩨉
𩤵	𬴄
𩤸	𩨅
𩤾	𩤳
𩥂	𩥞
𩥃	𱅥
𩥄	𩨋
𩥆	䮉
𩥉	𩧱
𩥎	𱅨
𩥐	𩡸
𩥑	𩨌
𩥼	𬴈
𩥿	𩥥
𩦂	𩦃
𩦆	䮪
𩦌	䮣
𩦚	𬴉
𩦠	𫠌
𩦶	𩤌
𩧉	𱄾
𩧊	𱄶
𩧋	𱄸
𩧢	𱅒
𩨎	龭
𩨗	𩨙
𩨠	𩨕
𩨳	𩨸
𩨴	𩩣
𩩘	𣄘
𩩦	𩩘
𩪈	𩪇
𩪌	𢓤
𩪗	𩪜
𩪘	𧬖
𩪟	𩪙
𩪥	䯍
𩫐	𩫑
𩫭	𬴢
𩫮	𩫝
𩫴	𩬜
𩫾	𩫶
𩬊	𤌩
𩬑	𨱬
𩬔	𩰂
𩬙	𩭗
𩬚	𰿎
𩬩	𮫀
𩬮	𩭗
𩬼	𩭤
𩭇	𩮞
𩭙	𩬣
𩭧	𨲋
𩭯	𩬾
𩭶	𩯁
𩮈	𩭓
𩮗	𩬬
𩮜	𨲞
𩮝	𩮂
𩮠	𨲟
𩮤	髳
𩮥	𱆇
𩮱	𩯲
𩮳	𩯧
𩮴	𣯧
𩮶	𩮸
𩯃	𱆄
𩯆	𬴨
𩯏	𩮽
𩰀	𩬤
𩰃	𨳂
𩰍	𨳲
𩰎	𨳮
𩰏	𨳚
𩰗	𩰝
𩰝	𨷚
𩰢	𩰡
𩰱	𩱀
𩰹	𩰰
𩰺	𩰽
𩱆	𱆒
𩱈	𱆍
𩱙	𩱯
𩱠	𱆑
𩱯	𩱙
𩱲	𩱶
𩱺	𩲂
𩲄	𩱽
𩲊	㚪
𩲍	𪽑
𩲏	𩲜
𩲠	𩲌
𩲣	𩲳
𩳖	𩳵
𩳛	𬵀
𩴐	𩳡
𩴥	𩴛
𩴵	𩴌
𩵚	𬶂
𩵡	𩷴
𩵦	𫠏
𩵩	𩽺
𩵱	𬶉
𩵹	𩽻
𩵺	𬶈
𩶀	𬶅
𩶁	𫚎
𩶏	䱅
𩶗	𬵊
𩶘	䲞
𩶜	𩶦
𩶝	𩸵
𩶯	𱇫
𩶰	𩽿
𩶱	𩽽
𩶾	𬵈
𩷄	𩷭
𩷍	𩵤
𩷒	𬶒
𩷓	鿵
𩷖	𱆱
𩷗	𩷬
𩷟	𩾉
𩷯	𤃖
𩷰	𩾄
𩷶	𱇮
𩷼	𫙝
𩸃	𩾅
𩸄	𫚝
𩸆	𬶖
𩸙	𩸺
𩸡	𫚟
𩸣	𬶙
𩸤	𬶚
𩸩	𬶝
𩸫	𩺖
𩸬	𬶜
𩸹	𮬚
𩹂	𱈃
𩹄	𩼟
𩹇	䱓
𩹊	𬶦
𩹎	鿷
𩹝	𬶡
𩹡	𬶘
𩹳	䲃
𩹷	𩵠
𩹺	𩽏
𩹽	𬶩
𩹿	𩹕
𩺀	𩼿
𩺃	𩼫
𩺝	𬶪
𩺞	𱈎
𩺪	𩺓
𩺯	𩻀
𩺲	𩵐
𩺵	𩷔
𩺷	𱆬
𩻈	𩶼
𩻗	𫚨
𩻧	𬶯
𩻬	𫚩
𩻮	𫚘
𩻰	𬶰
𩻱	𬶱
𩻼	𩼍
𩻾	𩻘
𩼄	𦌥
𩼇	𩾍
𩼎	𩼢
𩼭	𩻊
𩼶	𫚬
𩼸	𱆫
𩽇	𩾎
𩽈	𬶳
𩽉	𩽤
𩽊	𩸷
𩽔	𬶹
𩽛	𩼬
𩽮	𡚥
𩽷	𬶻
𩾐	𬷻
𩾒	𬷽
𩾔	𨾅
𩾜	𭄩
𩾝	𱉋
𩾷	𨾓
𩿁	𩿛
𩿄	𬷃
𩿅	𫠖
𩿑	𪀷
𩿗	𩿎
𩿝	𪀏
𩿠	𩿰
𩿡	𱈥
𩿢	𨾨
𩿤	𫛠
𩿪	𪉄
𩿫	𫚯
𩿱	𬸃
𩿺	𬸁
𪀔	𪃝
𪀖	𫛧
𪀛	𬸉
𪀦	𪉅
𪀭	𬷍
𪀻	𬸋
𪀾	𪉋
𪁈	𪉉
𪁊	𪁻
𪁋	𱈨
𪁌	𩋵
𪁏	𮭦
𪁑	𬸑
𪁕	𪁾
𪁖	𪉌
𪁜	𬸏
𪁥	𬷓
𪁱	𬸐
𪁵	𪁴
𪁹	𪂞
𪁺	𨿰
𪁽	𪅄
𪁿	𬸔
𪂀	𪂥
𪂈	𬸖
𪂉	𪂵
𪂋	𪂪
𪂩	𬸗
𪂫	𬸓
𪂹	𪃣
𪃃	𱊔
𪃏	𪉏
𪃒	𫛻
𪃓	𪂾
𪃙	𬯯
𪃦	𫛹
𪃪	𪀙
𪃮	𬸟
𪃯	𪂆
𪃱	𪁆
𪃵	𪁳
𪃼	𪄛
𪃾	𪃭
𪃿	𬸠
𪄌	𪅷
𪄐	𪃸
𪄕	𪉒
𪄠	𱊞
𪄭	𱈺
𪄮	𪆚
𪄶	𩀦
𪄹	𩀯
𪅂	𫜂
𪅃	𬸤
𪅜	𬷿
𪅟	𩀬
𪅰	䧾
𪅲	𮭐
𪅾	𬸨
𪆃	𬸫
𪆫	𱊨
𪆰	𬸭
𪆱	𱉄
𪆷	𫛾
𪆻	𩁏
𪇞	𪈞
𪇭	𩁞
𪈎	𪈎
𪈏	𱊴
𪈔	𱊉
𪈗	𬸄
𪈩	鸛
𪈰	𮬽
𪈴	𪈱
𪈹	𪅗
𪈼	𱊜
𪈿	𪈮
𪉖	𱊺
𪉘	𪉰
𪉜	𬸵
𪉣	𱊻
𪉥	𪉴
𪉦	𱊹
𪉨	𬸶
𪉮	𬸷
𪉱	𬸸
𪉸	𫜊
𪉽	𪉾
𪊄	𨣝
𪊋	𫜋
𪊍	𪊤
𪊑	𪊑
𪊒	𪊣
𪊔	𬸻
𪊠	𡔉
𪊨	𫜎
𪊻	𪊫
𪋉	𩃽
𪋏	𪋰
𪋝	𱋀
𪋡	𪋫
𪋼	𱋅
𪋽	𱋄
𪋿	𪎍
𪌈	𪍜
𪌐	𱋉
𪌒	𮮅
𪌗	𱋌
𪌣	𱋓
𪌬	𱋕
𪌭	𫜓
𪌮	𱋘
𪌯	𬹈
𪌰	𬹇
𪌼	饀
𪌽	𬹋
𪌾	𱋚
𪌿	𬹌
𪍀	𬹊
𪍇	𱋜
𪍍	𱋠
𪍎	𩜭
𪍒	𱋟
𪍓	𱋥
𪍘	𱋤
𪍚	𱋣
𪍞	𱋦
𪍣	𱋡
𪍤	𬹍
𪍬	𱋨
𪍰	𱋩
𪍴	𱋬
𪍶	𬹎
𪍷	𱋑
𪍺	䴷
𪍻	𪍽
𪍿	𱋈
𪎂	𱋭
𪎃	𪌊
𪎒	𪎒
𪎭	𪋩
𪎾	𬹒
𪏆	䵊
𪏈	𪏨
𪏓	𪏑
𪏠	𪏢
𪐇	𪐊
𪐘	䵝
𪐲	𪐳
𪐿	𱋸
𪑖	𪒰
𪑚	𬹗
𪑩	𤓅
𪑭	𪒖
𪑱	𪵓
𪑳	𬹕
𪑹	𪐱
𪒀	𪒋
𪒏	𪑔
𪒑	𪒦
𪒔	𪑴
𪒝	𪑇
𪒟	𱋹
𪒠	𮡜
𪒢	𪐙
𪒬	𬹖
𪒾	𪓆
𪒿	𬹘
𪓁	𨾄
𪓃	𪒌
𪓅	𪒯
𪓊	𪓉
𪓌	𢃒
𪓍	𪓏
𪓐	𬹜
𪓚	𪓘
𪓛	𱌀
𪓢	𪓥
𪓨	𪓠
𪓹	𱌈
𪓽	𬹤
𪔜	𪔝
𪔟	𱌋
𪔠	𤿰
𪔴	𪔳
𪔵	𪔭
𪕁	𪕎
𪕊	𪕑
𪕒	𪔾
𪕓	𪕗
𪕞	𱌍
𪕣	𬹭
𪕶	𥂺
𪖈	𪖊
𪖎	𪖋
𪖕	𪖾
𪖥	𪖪
𪖨	𱌕
𪗅	𪗈
𪗉	𬹲
𪗊	𰄘
𪗏	𩹵
𪗜	𬹽
𪗝	𬹻
𪗦	𪘍
𪗨	𩶌
𪗩	𱌝
𪗪	𬹿
𪗳	𬹾
𪘁	𠻙
𪘅	𰳆
𪘉	𬹵
𪘗	𪘠
𪘞	𬺆
𪘥	𱌸
𪘧	𬺋
𪘩	𬺊
𪘬	𱌷
𪘯	𪚐
𪘹	𪙰
𪘾	𪙒
𪙇	𪙆
𪙊	䶫
𪙎	𪙝
𪙏	𫜯
𪙑	𬺑
𪙕	𬺐
𪙝	𪘤
𪙞	𬺅
𪙦	𱌣
𪙫	𮯓
𪚅	𬺖
𪚣	𬺝
𪚩	𠼓
𪛆	𫠝
𪛕	𱍉
𪜩	𪜪
𪝖	𫢟
𪝬	𫬮
𪝵	𰂁
𪟖	𠛾
𪠤	𫥰
𪠷	𫩢
𪡇	𭌞
𪢍	𭉗
𪢎	𠱅
𪢔	𫬅
𪢥	𫩸
𪣡	𪶇
𪣶	𪣸
𪤆	𡍾
𪥂	𫥰
𪥈	𫯡
𪥧	𫰏
𪦽	𫼑
𪧝	𫳡
𪧢	𫳏
𪧦	𬈡
𪩖	𫶤
𪪋	𫧠
𪫅	𫹂
𪬿	𫻛
𪭐	𪭒
𪭱	𢭯
𪮰	𫼽
𪰎	𬀫
𪰖	𪰕
𪳷	𬂱
𪴆	𣜑
𪴯	𬅮
𪴶	𫠱
𪵍	𫾽
𪵢	𰚬
𪶿	𫥗
𪷈	𭱀
𪷓	𣶭
𪷚	𬉬
𪸐	𤆕
𪸫	𤈆
𪹃	𰞸
𪺟	𬌊
𪺱	𪺲
𪼮	𪼨
𪼼	𬎤
𪽇	𤰙
𪽍	𪽎
𪽾	𬥝
𪾿	𭧱
𪿛	𬒣
𫃐	𬖟
𫃑	𰪿
𫃞	𰫿
𫃥	𮉩
𫃷	𮉭
𫄇	𬘹
𫄎	𫄄
𫇠	𮎍
𫈯	𬝆
𫈹	𰰿
𫊬	𫊭
𫋐	𬠈
𫋧	𧈴
𫋸	𬡑
𫌙	𬡱
𫍊	𰴹
𫍔	𮙅
𫍘	𫍏
𫍯	𧭶
𫍿	𧫌
𫎛	𬇊
𫒆	𰽙
𫒞	𬭋
𫒡	𫓷
𫒢	𰾉
𫒷	𰾣
𫓋	𮣟
𫓠	𨧅
𫔘	𰿥
𫔡	𰿯
𫔼	𨸸
𫖘	𬢢
𫖞	𬱘
𫖢	𩔏
𫖬	𩒉
𫗑	𬲵
𫗕	𬳄
𫘾	𣭺
𫙎	𩴫
𫙮	𩻫
𫙴	𮬁
𫙽	𱆤
𫚄	𫙰
𫛅	𫛑
𫛑	𫛅
𫛹	𬸙
𫜦	𫜫
𫜳	𪓛
𫢏	𰁣
𫣇	𫣈
𫥝	𫥔
𫦔	𫦋
𫦙	𫥽
𫦮	𭄭
𫦷	𬓯
𫦸	𫦰
𫧚	𬔮
𫧝	𪟲
𫨑	𪠃
𫩵	𫩶
𫪛	𭇉
𫪩	𫪫
𫫬	𫫙
𫬆	𫫏
𫬛	𫫲
𫬱	𰇥
𫭟	塸
𫯓	𬻮
𫱡	㛇
𫲄	𭒨
𫲇	𬞬
𫲴	𭓀
𫳱	𬔐
𫴉	𫳜
𫶦	𫶄
𫹖	𬨭
𫺬	𪬑
𫻑	𫺹
𫽨	𫼭
𫾡	𫾏
𫾬	𦔼
𬂒	𦙾
𬂽	𬃂
𬂾	𬃒
𬃄	𭪢
𬄝	𬃛
𬄺	𣟃
𬅵	𬩠
𬆉	𬆂
𬆛	𪵂
𬇥	𬐮
𬉤	𬈏
𬉧	鿰
𬌇	𬏬
𬌓	𬌔
𬌦	𬌠
𬌰	𤞅
𬍁	𬌵
𬍵	𬍭
𬎌	𬍒
𬏲	𰣢
𬏹	𬌈
𬐱	𦣪
𬑡	𬑍
𬒒	𬒄
𬒗	𥗽
𬒪	𥒿
𬔂	𫬳
𬔐	𫳱
𬗏	𬘣
𬗺	𬙀
𬙔	𬙏
𬚗	𦖔
𬛂	𮌦
𬛘	𫆸
𬛜	𰯣
𬜯	䓣
𬞟	蘋
𬠰	蛍
𬡙	𬡚
𬢚	𬧹
𬣍	𬣫
𬣘	𬤗
𬦙	𬩂
𬧏	𮜝
𬧙	𬧔
𬧻	𫏻
𬩈	𫑂
𬪌	𬪉
𬫄	𬫑
𬫡	𫒶
𬬭	錀
𬬻	鑪
𬮇	𬮝
𬯘	𬯊
𬯣	𬁭
𬱂	𬱚
𬱈	𬱩
𬲚	𬳎
𬲛	𫗲
𬴛	𮪻
𬵂	𱇎
𬵃	𬶃
𬵨	鿹
𬵮	𬶑
𬶼	𱉉
𬷆	𬷇
𬷋	𬷌
𬷌	𬷋
𬷥	𬷪
𬹂	𬹆
𬹥	𭾕
𬹦	𫧸
𬹷	𩮆
𬼋	𭨭
𬽖	𪲬
𬾡	𬾥
𭀷	𭀳
𭈂	𠶒
𭉞	𠻲
𭉾	𰇊
𭊾	𪢍
𭋃	𭝤
𭋺	𩮆
𭍀	𭉧
𭍑	𭈄
𭍳	𭍟
𭎶	𩮆
𭑙	𮤮
𭔦	𰍡
𭢒	𰓤
𭧒	𰖏
𭧖	𰖚
𭨡	𰁈
𭫼	𣝬
𭭻	𬼕
𭮄	𭮊
𭱘	𰛨
𭳯	𭲍
𭶙	𤇻
𭺚	𮞖
𭻛	𭡹
𮀲	𥔂
𮂧	𬓖
𮉝	𦇭
𮉽	𫻬
𮎌	𩮆
𮑣	𮑁
𮘷	𰴵
𮜒	𰸙
𮜗	𰸦
𮝄	𮝳
𮟽	𰻨
𮢿	𨭢
𮤏	𮤳
𮨭	𬱾
𮨻	𬲱
𮬭	𮭣
𮭘	𱉁
兤	𰏵
𢆟	𠟳
𰂠	𪜺
𰂤	𬻢
𰂴	𫢜
𰃴	𰃳
𰃶	𭂖
𰆱	𰄟
𰈝	𫪑
𰉀	𪢋
𰍠	𰝡
𰎼	𰎦
𰏞	𢄢
𰐟	𢐖
𰑇	𢗈
𰔫	𫽫
𰔺	𫽢
𰖻	𬁘
𰘯	𰘅
𰙅	𪲹
𰚂	𪵇
𰚍	𰚣
𰛢	𣳇
𰝢	𰛱
𰟫	𰟄
𰠡	𰪵
𰡓	𰡉
𰣜	𰯻
𰧝	𮀧
𰫆	𰪪
𰫏	𰪼
𰫐	𮇺
𰫛	𬘗
𰫳	𬙄
𰯲	𰀢
𰳉	𮕖
𰴏	𫌩
𰴦	𰴥
𰴽	𬤃
𰹈	𰹯
𰻞	𰻝
𰼹	𮡹
𰽒	𬬝
𱀝	𨹺
𱃓	𮨩
𱃢	𬲧
𱃪	𬲽
𱄲	𱄪
𱆥	鿕
𱇋	𬶥
𱌖	𮜻
𱌛	𱌪
㑳	㑇𠊣
㑻	𠍌𠏷
㑼	𫣔𫵤
㒟	𧝥𰂶
㒥	仹僼
㒽	䌯𦋓
㓁	⺳⺴
㓄	𠬓𪠟
㓵	㗉𠟎
㔂	斴𣃌
㔎	㔑𠣅
㔙	奟𠡮
㔣	𠢿𣀜
㔩	𠤅𩇠
㔸	𠥃𠥶
㕒	嶬𰆕
㕢	𠭸𰇀
㖏	𧨚𧨤
㗉	䂮𠢌
㗘	𠽢𭉾
㗢	𫑕𰇖
㗶	𭇜𭋇
㗿	𠽫𪡛
㘔	㗷𫬐
㘙	𡆑𫪂
㘰	𡈿𡉜
㘿	圼𡍤
㙙	㴳𡔆
㙟	塱𤨡
㙤	㙈𡨄
㚇	𡕰𦡙
㚕	𡗻𡘉
㚖	𤽈𪥌
㚟	𡙟𬌾
㛨	𡠎𫱎
㜢	𡞱𡡎
㜮	𡤱𫱕
㜷	𡝠𡝡
㜺	𡣶𫲗
㝔	𡧮𡨇
㝪	𡪐𡫑
㞂	𡯵𰍮
㞃	𡯤𡯮
㞘	𡰪𡱰
㞚	𢩖𰍿
㞛	𡱹𡲏
㞞	𩩺𪨊
㞠	屪𡳇
㟁	𡶜𡶨
㟹	𠨥𡼅
㟽	磦㠒
㠆	𡵕𡼯
㠠	𫶢𰎐
㠢	𡾝𡾨
㠣	𡾒𫵷
㠧	𡻥𡿐
㠴	𢁯𢂻
㡀	𭁭𰏘
㡇	𢃣𧚊
㡉	㭹𢮂
㡓	𢃚𫷅
㡘	𢅏𢅖
㡮	𢇒𢇓
㢚	𢊔𢋡
㢝	𠫋𢋈
㤄	𢘀𢘨
㤒	𢙋𢡋
㤖	詝𫹿
㤞	𢖲𰑛
㤿	𢜰𢞷
㥛	𢞊𢞳
㥞	𢢝𢤪
㦎	𢛯𢟸
㦦	𤄎𫻁
㧋	𢪂𬌪
㧐	㨦𢱤
㧺	𩎽𩏒
㩍	㨲㩞
㩨	㨹𢴥
㩹	㩸𢶣
㩼	𡖙𢻈
㩿	㪂𢼁
㪃	㪋𢼔
㪍	𢾢𭣲
㪻	𢍶𫿳
㬤	𣉓𪱀
㮪	𦨰𦩺
㮰	𣗽𭪣
㯀	𣒀𰘡
㯩	𣜹𤎊
㯺	𣔿𣠿
㯻	𡚀𣠔
㰂	𢸙𰗵
㰕	㩘𭬮
㰘	𣟗㰘
㰣	𣢃𣢙
㰨	𣢱𣣦
㰲	𣤐𣥀
㲀	敐𭮨
㲃	𢽭𣪙
㲄	𡎷𣪝
㲨	𥧢𨉴
㲯	𣰦𰚪
㲰	𰚔𰚴
㲴	𣱪𣱯
㳏	𣳪𣷱
㴘	𣶀𣻥
㴬	𣽜𰜹
㵗	𣳆𮙢
㵩	𦺁𦻜
㵶	𣳟𤁢
㶌	𣾍𭳝
㶒	㵅𰛩
㶕	𤄒𰝗
㶴	𤇔𤈕
㷇	𡌪𡖨
㷝	㟮䃐
㷮	𤒖𤓗
㷹	𤒽𦻐
㷿	𤈷𰟩
㸅	𤊵𰞍
㸇	𤎺𤓎
㸎	𣌍𬋇
㸕	𬋦𭶹
㸢	𤗌𤗩
㹁	𤙝𤚒
㹄	𤚠𤛵
㹗	𤛒𤛴
㹙	㹚𪺴
㹪	狦𤞹
㺛	𤟨𤡹
㺦	𤣆𤣈
㺸	㺸㺸
㻝	瓎㻋
㻬	㻯𤨹
㼐	𤬊𭶳
㼔	𤬆𤬒
㼖	瓥𤬤
㼤	𤮈𤮛
㼦	𤬳𦈩
㼵	𤭌𦉁
㼻	𫧏𬎧
㽅	𢍪𤮘
㽡	𤲤𤲦
㽢	䅖䎨
㽩	𤳑𤳒
㾃	𤵚𤵩
㾊	𤕹𤶬
㾪	𤵙𩩭
㾭	𤵰𤶍
㿏	𤸷𤺽
㿒	𤹷𤺜
㿖	𪽮𬏞
㿙	𤼟𤼤
㿴	䐛𤿽
㿸	𥀗𥀤
㿺	𤿈𤿉
䀊	𥂔𥃃
䀑	𥄗𦔹
䀛	䀜𰥓
䀠	𥈀𮊂
䀱	盽𫞳
䀺	𠌪𥃧
䁃	𥋦𥌜
䁈	䁉𢾥
䁋	𥇱𫌣
䁏	䁘𣉋
䁓	𥅢𦖸
䁝	𥌴𰥞
䁮	𥋋𥌳
䁲	䚑𥋻
䁴	𠿞𥊳
䁻	䀥𥍐
䂄	𥍜𰦊
䂬	𡊼𥒽
䂳	𥑥𥒑
䂹	𥓭𨹾
䃣	䃣𰦨
䄆	䄑𥙱
䅃	𥞣𥞱
䅌	𧆇𪌭
䅑	䅗𥡜
䅘	𥟂𬓡
䅳	𥟷𫀬
䆂	𥣹𰨿
䆅	𬹲𰨳
䆞	𥦒𥧘
䆩	𥦏𥧤
䆬	𫳧𬥙
䆷	䆕䆝
䇘	䊺𥫻
䈈	𥭬𥮄
䈱	𠚘𥮛
䈻	𥮉𬙤
䈽	𥭤𥱐
䉌	𥴦𥶼
䉧	𥳩𥷢
䉰	𥰹𥳴
䉱	䉩𬕦
䊜	𥻁𰪫
䊨	𥡜𥢵
䊯	𮇋𰪩
䊺	𥾙𫄚
䋂	𥾤𥾥
䋎	䘺𬘜
䋰	𦀤𦀥
䋸	䙉𦅑
䋼	𦀚𫄮
䋾	𦅁𬘲
䌁	𬘱䌁
䌇	𦄨𰬱
䌠	𣤭𦆃
䌤	𦁥𦆤
䌪	𦇾𬙁
䌵	𦅉𦆂
䍋	𦈼𦉖
䍘	𥹄𦊮
䍤	𫅅𮊞
䍫	𦍔𦍥
䍸	𤚽𤝔
䎓	𦑇𦑶
䎗	𦑽𦒓
䎘	𬚄𮋕
䎚	𦒄𦒎
䎛	㖈𦒵
䎠	㐡𦓏
䎧	𢮏𦔑
䏂	𦖪𨺦
䏙	䏙𰮐
䏥	𦙇𦨸
䏦	𦧘𬚸
䏳	𦠟𦠠
䏿	𦜑𦜹
䐣	𦠆𬁽
䐤	肞𦟎
䐴	䏗𦟡
䐵	𦡽𪏍
䐾	𦡇𰯞
䑂	𦚪𫵬
䑃	𬂔𮚩
䑔	𦥡𦥥
䑜	𦧢𦧤
䑦	𦨛𦩷
䑰	𬜙𬜚
䑴	𦨘𦪆
䑼	𦩙𰰌
䒊	𦫦𦫬
䒷	𤫵𦯚
䓊	𦸭𦹊
䓼	𦳨𧀔
䔡	䓊𬝁
䔫	𬝸䔫
䔯	𧃗𨡱
䕡	䕡𰱩
䕳	𦰴𦱨
䕷	𧂷𧃲
䕺	𧆁𮆜
䕼	𧅻𬝴
䖘	𧇢𧈒
䖦	蠿𪓭
䗃	𧔢𰲳
䘋	䘂𧐦
䘕	𧘃𧘅
䘿	镼𩭪
䙎	𧚃𧜋
䙔	𧞨𫋲
䙘	𧞛𧞰
䙟	𧝕𧝖
䚉	𧡘𬢐
䚞	䚟𰴤
䚢	𧤇𧤈
䚩	𧤦𫌯
䛗	𧧃𧧰
䛩	䜑𧪛
䛭	𧨫𰵰
䜂	𧬁𰶅
䜋	𧭾𬤉
䜏	𧩭𰶇
䜚	𧮅𬤪
䜰	𧯌𧯔
䝊	𤟃𧲌
䝕	𤣒𬥄
䝯	𥅓𬥵
䝳	𠠋𬥡
䝻	𡨢𧹕
䞂	𧸀𬥻
䞆	𧶈𧷣
䞈	𧵥𧹑
䞒	𰊕𰷯
䞘	𧺞𬼲
䞜	䞸𧻳
䞯	𠓗𣬚
䟃	𧾋𫎺
䟒	𧼚𫹩
䟛	䢌𧺡
䟼	𨅐𨖴
䠆	𨅝𫏃
䠗	𧻁𨃔
䠟	𨄧𰸈
䠠	𢅊𰸛
䠯	𨈅𨈋
䡅	𨋮𰹳
䡗	𨋑𬨆
䡘	䡒𬨉
䡚	𨌊𨌓
䡝	䩩𰺑
䡵	𨍨𫟦
䡷	𨍰𰺡
䡽	𨏘𮝰
䡾	𨏾𰺠
䢥	𨕆𨕋
䣊	䣣𨜂
䣟	䣠𰼀
䣪	䣮𨠓
䣵	䤊𨠧
䤍	𨢥𰼑
䤏	𨢙𰼒
䤘	𨣔𨣲
䤪	𨦃𬭆
䤬	𨪍𰾈
䥍	𨫔𨫦
䥑	鿏𨦎
䥝	𨰅𰿁
䥶	𬫂𰽝
䦌	𨳳𮤬
䦘	𢩆𨸄
䦛	䦶𨵺
䦪	䦖𰿴
䦵	𨳴𨷬
䧎	𨸫𨹆
䧢	貖𨸟
䧦	𦖯䧦
䧯	𨼐𨽊
䨡	𩄙𩄥
䨺	𩅣𮦖
䩉	𩈨𬳗
䩌	𤎂𩉈
䩚	䩘𩉱
䪗	𩋥𩐀
䪙	䪖𩋟
䪫	𩐺𱂑
䪾	𩑘𫖬
䫁	𦤫𩓑
䫒	𩑥𩔉
䫜	𪃨𬱮
䫦	䪺𩕭
䫧	𩔇𩕍
䫩	𩕞𬱬
䫵	𩕰𱂞
䫶	𩕒𫖺
䫺	𩖢𩙛
䫾	𩘆𫠈
䬇	𩗜𩘍
䬌	𩗸𱃄
䬑	𩘳𩙊
䬘	𩘲𩙮
䬪	𩚼𱃳
䬲	𩚘𬲯
䬼	𩝤𩟁
䭀	𩛓𩠇
䭂	𦤡𨜀
䭃	𩠈𪌿
䭑	䭠𫗱
䭓	䅱𱃹
䭡	𩝄𱄉
䭢	𩞜𬲲
䭭	𩠬𬱯
䭴	𩡧𩦮
䭻	𩡱𩡷
䭿	𩡹𩧭
䮂	𩢚𱅄
䮗	𩤧𬴁
䮥	𩦣𩧂
䮾	𩦳𩧪
䯏	𩩎𩩻
䯢	𤼑𩪮
䰀	𩭏𩮑
䰎	𩯿𱆃
䰒	𩮡𩯼
䰠	𩳱𩴋
䰰	䰭𩴶
䰻	𪺚𱇕
䱀	䰲𫚐
䱒	𩸆𱇰
䱜	𩻶𱇷
䱞	𩹟𩺚
䱠	𩹆𩻣
䱬	𩸠𩾊
䱮	𩹃𱆵
䱱	𩹋𬶤
䱷	䲣𭤐
䱸	𩹔𫠑
䱹	𩹦𬶣
䱻	𩹂𮬡
䱾	𱆹𱈆
䲅	𩷪𫚜
䲚	𩽓𱈖
䲫	𡰎𮬦
䲬	𨾛𪀍
䲸	𩾴𮭡
䲹	𪀇𱉖
䲾	𨾢𩿸
䳀	𨾤𪀒
䳁	䳊𨾩
䳍	𬶽𮭥
䳎	𨾹䳎
䳓	𪀧𱉦
䳔	䳎𨿀
䳟	𪆌𱊂
䳤	𪂟𫛮
䳦	𩀈𪃗
䳨	𫛃𬸛
䳭	䳭𱉼
䳲	𪁧𱊙
䳳	𪃚𪅁
䳹	𪄓𪄺
䴅	𩀴𩿜
䴝	𪉼𱊼
䴭	𪌎𬹅
䴱	𥹈𫜒
䴲	𥽘𱋊
䴳	𪌡𱋎
䴷	𬹉𮭼
䴹	𪍯𱋙
䴺	𭐭𱋝
䴿	䵆𪍭
䵂	𪍼𱋪
䵇	𢊰𢋮
䵒	䵑𪐌
䵣	𪐪𪐵
䵤	䵡𪒫
䵳	𪐹𪑅
䶢	䶠𬺍
䶣	𤘑𬺃
䶨	𮯈𱌵
䶪	𪙻𬺕
䶱	𪚽𱍇
七	𠀁𠀣
丞	㞼𤇏
丮	𠃨𩰊
丸	𠁽丸
主	丶𤤛
乍	𠆦𨕚
乎	𠂞𰲙
买	買𧵽
亃	𠄈𦧾
了	瞭了
亇	㐃𠄐
二	𠄠⼆
井	丼宑
交	䢒𨓩
产	産𨹞
亸	嚲軃
什	甚什
仔	𠎶𰫙
仨	𠫽𠬙
们	們每
仰	佒卬
仵	𠇪𠇫
伙	夥㚌
传	傳𠇇
伦	倫𠊇
伪	偽僞
伽	𨔽𮤿
佅	𠇠𪥊
佇	㑏𡀐
佌	𠈈𢇌
位	𫲿𬔤
余	餘𫢉
佟	㣠𢓘
佢	𠍲𠏛
佣	傭庸
佥	僉𠑲
侀	侀𬽰
侂	𠈁𪜲
侄	妷姪
來	来來
例	例𠊖
侑	右酭
侖	仑𠉙
侘	𠊴𫢥
侚	𢔐𢕊
侧	側夨
侨	僑㝯
侩	儈𩦱
侪	儕𠉸
俓	𠆻𠇹
俔	伣悓
俩	倆𠈓
俭	儉𠈏
俵	㧼䞄
倍	𠊑𠋭
倚	掎𠋣
倛	𠎞𠔶
倡	唱娼
倢	偼𠌿
倫	伦倫
倬	𠍬𠟅
倭	𬾒𱀚
倲	㑈𠍀
停	仃𫢷
偭	𠌛𠎡
偰	𠎇𫶩
偾	僨𠏱
傁	𠊯𠌌
傄	𠉈𠋚
傅	𠌽𫝊
傜	㑾𠏈
傭	𦟛𫢻
傻	儍𤷩
僆	𫢪𫧽
僉	佥㑒
僒	侰𠌣
僝	𠊩𢢁
僩	僴𰂎
僭	僣朁
僮	偅働
僵	殭𤀌
價	价価
儇	翾𠐛
儐	傧𰌽
儓	㒗𬾶
儕	侪㑪
儘	侭尽
儚	𠐧𬿽
儦	𢖐𬿚
儱	𫢒𫣏
儵	𡤥𨤨
儹	儧𰃆
儼	俨𪝫
儿	兒⼉
兇	凶𠒋
兤	𭀨兤
六	六𠫪
兮	𠔃𬺸
冎	𠙼𡆥
冗	宂冗
冟	𪞓𬝙
冢	塚𠣥
冱	冴沍
决	決𣲺
减	減𭂢
凑	湊𣽵
凔	𠖸𰃷
凕	𣼗𪷆
凜	凜𠘡
凯	凱𧇔
凳	櫈𤼫
凵	凵⼐
刌	𠚳𢩭
刎	歾𰄡
刓	㝴𠝳
刖	跀𠚯
刨	鑤铇
刲	㨒𠝥
剒	𠝜𠟏
剭	𪑱𬆴
創	创𬔚
剶	𠛖𠛮
劈	𨐯𰠙
劍	剑剣
劑	剂剤
劘	𠞥𠠒
务	務𥍦
劬	𭇕𰞨
励	勵𠠿
勔	𠡳𫤫
勝	胜𠅫
勢	势𫝑
勥	𠣀𠣃
勨	𠢰𠢴
勬	勌𠢚
勲	𪥝𬊫
勵	励勵
勸	劝𰒣
勼	𢜥𫩃
勾	句𭙊
匀	勻𠣐
匈	匂𭅅
匊	𦥑𰅛
匑	匔𰸻
匜	釶𠤷
匝	帀𠂝
匠	匞𮞆
匫	匢𠥋
匱	匮𫧘
匼	𠥕𢈈
匽	𭂾𭅝
千	仟韆
卅	𠦃𠦄
午	𨾟𰅭
卍	𭂪𭅫
卐	卍𬼃
南	𡴖𡴟
占	佔𰉏
卣	㔽𪾏
卦	𤌻𥝒
卨	𫧯𫶩
卩	𠁾⼙
卸	缷䣃
厏	㡸𠩎
厒	𠪦𢩋
厓	厑𪞢
厜	𠪪𤷣
厢	廂箱
厭	厌𰆪
厰	厂𫨋
叀	𠫢𤰔
參	参參
叇	靆𱁥
又	有⼜
发	發髮
叢	丛𪩝
叩	敂𧥣
史	㕜𫪊
右	𠮢𫳌
叽	咭嘰
吆	䶸吆
合	敆㪉
后	後𠮮
吕	呂呂
吞	呑𦙖
吪	𠷸𨅌
吸	噏吸
呇	𬇖𭯶
呈	𭇆呈
呜	嗚歍
呥	𠯍𠰩
呬	𠰝𧦁
呴	𠯜𠴁
咄	嚉𡁨
咉	𠮴𫩣
咋	𠷆𠷿
咠	舙𠶻
咢	㖾咢
咼	呙𩰬
咿	吚𠲖
哓	嘵𠵰
哔	嗶𥑖
哝	噥譨
哢	𠱚𧧎
哦	誐𫪋
哯	咞𠯟
唉	欸㗒
唊	䛟𰇕
唛	嘜𠳜
唬	虎𫬲
唲	𠴶𠴺
唵	𠵵𠺄
啄	啅噣
啊	呵嗄
啎	𠵦𧺴
啕	咷啕
啚	𠴿𧖳
啞	哑唖
啣	𭊷啣
啸	嘯歗
喀	衉䘔
喇	喇𦎏
喉	㗋𦞈
喋	𠴬𠿚
喑	噾瘖
喙	喙喙
喫	𫩬喫
單	单単
喳	㗫喳
喽	嘍𠶭
嗂	𠿌嗂
嗄	𣣺𭉿
嗇	𤳋𮧌
嗒	𢟉𭉙
嗓	𠼙𰇢
嗖	㖬𠷃
嗘	𠳸𫩹
嘁	𠻏𡂔
嘇	𭈧𰇼
嘈	䜊𡅰
嘛	嚜㕰
嘥	𢳜𫬧
嘱	囑𰇰
噁	𫫇𫫖
噅	噕𠯠
噆	𠾱𡄋
噎	㖶𩜺
噦	哕𧬨
噧	𡂖𬞒
噩	𠥡𬻟
噬	唑𭇹
噴	喷噴
嚂	𡅞𰈓
嚉	𠲝𪒶
嚘	𫫫𭋨
嚝	𫩕𭇗
嚩	𭌺𰈶
嚮	向𪢞
嚱	𡃰𰇣
嚵	𡁅𡅛
囀	啭𫝚
囉	啰囖
囍	𡄝𡅕
囐	𠰙𰈯
囚	𡆢𡆥
囡	囝𡇨
园	園薗
困	睏𣏔
圓	円圆
圗	𡈄圗
圥	𠒶𡴆
圪	𡉛𡍡
圬	杇釫
圯	𡊊𪣀
圳	甽𫭜
坉	𡉒𡉫
坒	𬆻𭎔
坔	畓𡉺
垓	姟畡
垧	埫晌
垯	墶㙮
垴	堖𡍍
垸	䯘𡌗
埋	薶霾
埚	堝煱
埠	埗步
埨	𤲕𫭢
培	㟝𡌮
堄	𠆔𨺙
堗	㟮䃐
堚	𡍦𪣒
堮	𡑇𡓐
報	报報
堽	鿍𡌕
塑	塐𭏺
塗	𡍼𭏚
塚	塜塚
塣	𣵹𣹽
塼	𫭞𫮯
墁	㙢𡑦
境	㘫𮄹
墊	垫𪣖
墋	𡑐𫮅
墍	𡉙𡏲
墠	𥑲𫮃
墢	𡍰𫭨
墨	墨𥂮
墭	㼩𪾓
墳	坟墳
墶	垯𡐿
墽	嵪𡒋
墿	㘮𰉣
壎	嚑𤏍
壕	濠𡐒
壟	垄壟
壠	垅𡏡
壣	𡑜𪤚
壧	𫭲𫮿
士	𰌩⼠
壸	壼𡈋
壺	壶壷
壻	𦖜𰭸
壾	𥂇𥂷
夃	㚉𡕔
夆	𢩸夆
夗	夘𡖅
夫	伕𧥱
夬	叏𡗒
夾	夹𡔡
奊	𥸸𪥎
奎	䖯𡌤
奐	𡘔𮊆
奘	弉𡘾
奞	㚝𨾮
奡	𪟊𫦍
奧	𠆇𢍢
奭	𠁗𡚐
奰	𡚤𤣂
奱	𠮖𢌕
奴	㚢𰂈
奿	𡚪𡚺
如	𫰏𫹌
妍	姸蔅
妎	𡛐𡟲
妓	𡛇𪥩
妚	𡜊𫰩
妣	𡚧𡛗
妥	𡛎𢼻
妫	媯嬀
姊	姉𡛷
姌	㚩𡛓
姐	她媎
委	𰅤𱀇
姗	姍㛽
姛	𡜝𩒗
姜	薑𦎕
姹	仛奼
姿	𫱝𰛳
威	𤰴𪭏
娘	孃𭑧
娙	𡜇𫰛
娠	㛛𡝌
娲	媧𡢓
婁	娄𣫻
婉	䩊𡟰
婍	䄎𰨌
婗	𠒰𡟉
婜	𪦑𫰐
婞	𡟡𰌍
婬	𡝇𪦢
婵	嬋𡠐
婸	𡢈𰋸
婹	𡠇𡢇
婺	𡜹𭤇
媅	妉㚮
媧	娲𡢠
媰	㛀𡦅
媸	妛𡟎
嫂	㛐㛮
嫃	𪦵𫱇
嫖	闝𡤚
嫚	𡠪𡢚
嫧	𡢲𰌇
嫫	𡠜𢂳
嫱	嬙𡣰
嫸	𡣌𡤮
嫺	𡣟𫱢
嬐	㚧𫰰
嬔	婏𡤳
嬕	𡛄𡝾
嬣	𪥰𰌖
嬪	嫔𡝏
嬰	婴𰋷
嬿	嬊𡤈
孀	㜀𬰍
孁	𩃩𫲚
孂	𤃾𥶞
孅	𡣳𡤪
孋	㛤𡠈
孍	𡣜𫲠
孓	孒𠀔
孔	空𡤿
孛	𡥇𡥞
孜	𫲡𰌡
孥	帑𠩨
孱	𤸦𰌱
孵	𡥭𨹴
宓	𧶡𭷩
宙	𦁖𫳂
宛	𪞏𭓩
宠	寵𠖥
室	𩋡𪧧
宧	𥦪𥦳
宸	䆣𫤹
寁	𢧣𢧺
寄	𠖏𭔃
寎	窉𥧃
寏	𡨡𥦺
寔	𥦽𭁼
察	詧𰌵
寠	𡫤𪧘
寢	寝𮄊
審	宷𫳢
寯	㝦𥨣
寵	宠𫳭
寷	𡫋𫲸
对	對𡭊
尒	厼𡭗
尚	尙𫩠
尣	⺏⺑
尫	𠒉𰍭
屑	榍㞕
屘	𡱬𣬥
屙	㢐𡱻
屠	𫻷屠
屢	屡屢
層	层層
屦	屨𧀓
屮	屮⼬
岍	𨸦岍
岓	㟓𡵱
岘	峴𡷹
岰	𡵿𰎓
岻	㞴𡵮
岿	巋𡿢
峃	嶨𫶋
峗	峞硊
峙	崻嵵
峤	嶠㠐
峪	硲𭖦
峮	㟒𡸙
島	岛﨩
峽	峡𰎟
崄	嶮𭭶
崇	崈𡸶
崒	崪𡸝
崔	嵟𡹐
崖	厓崕
崗	岗𡸿
崜	𡶲𡷔
崣	嶉𡹜
崮	崓𡹍
崱	𡺢𰎖
崴	𠋘𫶆
崵	𫵵𫶖
嵃	嵼嵃
嵉	𡹂𡺣
嵊	𡹴𡼺
嵋	𠃜𡼴
嵒	喦𡍸
嵝	嶁㟺
嵩	崧㟣
嵬	㠕䃬
嵷	嵸𰎌
嵸	𡵝𡵷
嵼	𡶴嵼
嶀	𡹻𡻻
嶂	𬎗𭗍
嶒	𡼳𡿘
嶔	嵚𬫘
嶜	𡼫𡾡
嶧	峄𡵸
嶪	嶫𰎑
嶮	崄𡸴
嶺	岭嶺
嶽	𭗢𰎫
巁	𡽇𡿋
巊	𡾸𪩎
巋	岿𭖸
巍	𡿁𡿆
巏	𡺟𡺹
巖	𭗷𰎠
巗	𪨷𰏂
巩	鞏𠔣
已	以𢀒
巸	𣢮𦣤
帐	帳𰅸
帑	伖𫧞
帕	帊袙
帗	𢁵𤜧
帘	簾𮆴
帞	絈絔
帥	帅𫡆
帶	带帯
帷	𠥎𠥛
帻	幘𢅙
帼	幗蔮
幃	帏𬰭
幄	𢄰𧛐
幌	𣄐𣄙
幟	帜𢡠
幠	𢅿𭘓
幡	旙旛
幢	𣄛𣄢
幣	币𧝬
幩	𪩸幩
幬	帱𬰯
幵	开𢆛
床	牀𢃅
庐	廬𡳬
库	庫𢊾
废	廢𭙎
庪	𢈧𢉎
庰	𢊜庰
庼	廎䯧
廇	𠪐𢊺
廎	𢊼𪠌
廏	𢋁𫳷
廒	厫廒
廢	废廃
廦	𠪮𫴎
廨	𪠘𭆍
廱	㢕𢌏
廿	卄𭺪
弓	𭚥⼸
弗	𢎵𢏍
弙	㢪𢎰
弞	𣢀𬮼
张	弡張
弤	𢎸𢏁
弱	𢐅𭋘
弴	㢯𢐻
張	张𫣖
彀	𠥚𢐙
彍	彉𭚦
彖	𢑡𧰺
彜	𢑲𪪷
彬	份𢒹
彶	叝𠫳
待	呆𥩳
必	𠂭𰅡
忍	㣼忍
忏	懴懺
忘	㤀𢚚
忚	𢘬𢙚
忝	㤁𭕇
忞	忟𢗡
快	哙𢘦
态	態㑷
怂	慫𢠰
怃	憮㒇
怅	悵𤟔
怍	㤰𢜉
怓	𢘾𢞙
怛	𢘇𢛁
怠	殆𫵝
恁	㤛𢗖
恍	怳𦬺
恘	恷𠁫
恙	𫺵𭼞
恨	𢙃𢚉
恩	㤙𪫩
恫	挏痌
恲	㤣𫺨
悚	愯竦
悡	㥎𢤂
您	儜恁
悲	𠾦𭝢
悸	痵㑧
悻	婞𢙼
悼	𢛂𫺕
惃	𢟦𢠎
惊	驚𢢩
惌	𥧉𥧛
惛	䫒𩇇
惜	𢡽𱋃
惝	㒉𢠵
惡	惡𢛫
惮	憚𢠸
惯	慣遦
惵	𢛐𢜨
惶	遑𪱦
愉	歈㥥
愐	𢗔𢗙
愓	𢠽𰐿
愕	㦍𥈭
愛	爱𰑀
愦	憒𢤳
愲	傦𭘱
愷	恺𫷋
愺	𠷚𠹊
慁	㥵𢜹
慃	傟𠃽
慄	慄𢢙
慇	𢜄𢟝
慐	𢜊𰑟
慑	慴懾
慒	𢥱𫵯
慘	惨𢠊
慝	𢤃𰑋
慢	𢢔𭜌
慥	𢱤𭞅
慨	嘅慨
慯	𤵼𫹽
慰	𢟬𢠢
憁	愡𢛌
憤	愤憤
憥	憦𢥒
憧	𢤖𢤤
憲	𢞩憲
憹	𢙐𢥯
懀	𢘏𢙓
懂	㤏𢤦
懆	𢥼𭝱
懈	解𢢣
懌	怿𢗜
懎	𢞮𢠁
懑	懣㦖
懔	懍𢤭
懙	𫹮𫺙
懜	顭𢟼
懣	懑𢡛
懪	𢥑𢥟
懭	𭜡𰐾
懰	𢞓𰑙
懶	懒懶
懸	悬𢡪
懼	惧𭜼
懽	𬷴𭞞
戀	恋戀
戁	嫨𫺷
戔	戋㦮
戗	戧摤
戠	𧧬𫻫
扂	𠂼𭠄
扉	𡨰𨵈
扎	劄紥
扐	𠠸𪭊
打	咑𬹧
扚	𢪰𢯊
扜	扝扝
扠	𢩩𢹓
扦	𢳍𢸯
扫	埽掃
扮	𢪆𢮈
扰	擾𢺕
扴	𢪅𫽜
批	𢱧𱁑
抄	𫢡𬆠
抉	挗觖
抗	伉𢪨
抢	搶𢷇
护	護𢨥
抩	𢪈𫨳
抯	㪥𫨶
拃	𫾩𬆢
拆	𫷫𫾯
拍	𢫦𫨷
拒	歫距
拘	抅𢳉
拙	䂐𢼍
拣	揀㪝
拦	攔阑
括	𢬸𬛺
拾	拾𬠹
持	𠱾𰩠
挈	𢭋𢲞
挌	𢼛𢾏
挚	摯𢳊
挡	擋攩
挣	掙𧶄
挤	擠𡬚
挨	捱𢰇
挱	𢬰𣴷
挲	挱𭢃
捂	摀𢫸
捔	𤞴𧣀
捝	挩𢬁
捞	撈𢭂
损	損𢿃
换	換𢯉
捭	𢬽𢮆
捲	𢃩𢰪
捽	𢪄𢬪
掃	扫掃
掆	㧏𢱫
掑	𢮜𫤱
排	𣝁𫸝
掔	孯𡦋
掝	㩇𭠵
探	𢲘𢶁
掤	𢵁𰔘
措	𢵄𱀗
掳	擄𢲸
掷	擲擿
掸	撣𢶁
掺	摻攕
揅	𮀶揅
揠	椻𣚼
揥	𪪶𪯐
揩	𢾆𭤀
揮	挥𫸞
揾	搵𤛁
搆	𢰎𢲱
搎	𢶛𰓧
搏	𪠑𫼁
搡	𬧉𰓨
搫	㨇㩯
搳	捾𫳶
摈	擯𢷤
摍	𢳔𢴀
摔	𨄮𰔜
摗	𢲆𢳯
摙	𪜆𫽁
摚	𢻒𰕒
摜	掼𫿖
摡	𢪑𢷽
摦	𢶎𥧰
摪	𫽣𫿏
摭	拓摕
摮	𢳆𢶗
摰	𢴷𢴸
摺	折抧
摼	挳𰓱
撅	厥噘
撈	捞𢭐
撌	𢵟𰔋
撝	㧑撝
撣	掸撢
撥	拨𫝼
撮	𢲻𤑧
撵	攆𢺘
撼	㨔𰓭
撿	捡𢮦
擄	掳擄
擋	挡𫻹
擐	𢸃𫿐
擟	㧠𪭧
擠	挤㨈
擣	𢭏𢷬
擤	㨘𪖥
擫	㩎𢬍
擭	蒦𣡀
擰	拧𢴕
擲	掷𬅈
擴	扩拡
擸	𢴫𫿢
擽	攊㧰
擾	扰𢹎
攃	𫊈𭢦
攊	𢹠𫾐
攍	㨕𢺆
攝	摂摄
攞	攎𫽋
攢	攅攒
攣	挛𰫹
攥	揝𭣎
攧	𢺗𭣇
攪	搅撹
攬	揽𢳢
敀	𤽐𫨷
敂	𢼃𢼒
敉	侎𢘺
敞	僘𰕋
敧	𣀬𭣿
敱	敳𣪱
敹	𭤆𱂹
敺	𢿛𰕅
敽	𣪽𰕈
斂	敛𰖲
斎	𩝦𭤕
斐	奜婔
斷	断𠸿
旀	㢱𣃥
旐	𣃿𰕨
旞	𣄚𣄧
旧	舊𦾔
旱	晘𫝒
旴	𣅙𤕐
旺	暀𫭠
昉	昘𭽍
昒	曶𣇤
昙	曇𣊯
映	暎𪰔
昤	㬡𣌟
昪	𣅹𣈠
昫	朐㫬
昱	𦊢𪰣
晄	兤𭀬
晅	𣈶𣉖
晉	晋𫞄
晕	暈煇
晙	𣇚𭦕
晛	𣅸𬀪
晜	𣋥𬀹
晟	晠𠕠
晢	晣㫼
晬	𣅢𪰓
晰	晳𣇮
晶	𣇵𦜳
暀	𣇭𣈧
暈	晕暈
暐	𦗇𬀩
暧	曖𪒱
暳	㬩𬁓
暵	䎯𦟫
曅	𣊚𬀽
曉	晓𬁕
曖	暧𭩊
曛	𣊳𣌕
曠	旷昿
曥	𣆐𬀭
曩	𪱒𭧽
書	书書
會	会𣌭
朐	𠣪𦚧
朡	𣍶朡
朥	𦛨𫆟
朧	胧𪱨
木	𡵬⽊
朳	㭭𦓧
朽	㱙𣦿
杉	檆㭅
杋	𣏆𬂢
杒	梕𣏉
杓	𣏐杓
杙	𢬩𭩫
杜	𡍨𢾅
束	捒𤙨
杼	䇡𣏗
杽	𤘶𨥋
枅	𣓖枅
析	㭊𣂔
枓	𣏸𣙞
枕	𣏝𭩝
枞	樅𪲧
枥	櫪𣙽
枫	楓𣑲
枯	𣒞𤖲
枷	椵鉫
枸	𣕉𣙱
枹	鞄𣑿
枻	栧𮎉
柅	抳𨋗
染	𩃵𭰏
柯	牁𣝺
柰	㮈㮏
柲	㧙䪐
柿	枾柹
栋	棟𤗗
栌	枦櫨
栙	𢭎𪲋
栠	栣𬓧
栤	𣐚𣑏
栵	𣔜𣖊
栾	欒𣡵
桂	楿𣑖
桃	𣑯𮎮
框	𣒸𨴑
桊	棬𣗷
桌	棹槕
桐	𣑸𰇋
桘	𬂫𬄄
桠	椏𣏎
桡	橈𦪛
梀	𪳚𬃭
梏	牿𰇶
梐	㯇𭠷
梖	𪱷𬃽
梣	𣘕𣠟
梭	𣜤𥭟
棂	櫺欞
棉	㮌𣏜
棏	㯖𣙵
棒	㭋𣘙
棬	椦𥁸
棰	箠𪳕
棵	科𪳑
棶	𢯦𫼲
棹	櫂䑲
棺	𣑄𰨉
棻	㯣𦯳
棽	𡹚𣕯
椅	𣎷𬃪
椊	枠㯜
植	㯰𰗝
椓	㧻𨧧
椔	菑椔
椟	匵櫝
椰	㭨𣚋
椴	葮𫞌
楔	榍𪳣
楗	揵𨵭
楙	柕㮊
楤	𪲨𬄔
楫	檝艥
極	𪳜𫤱
榅	榲𫀚
榆	崳楡
榐	𣒅𣡃
榙	㯚𣗶
榠	𣘔𣙣
榦	𠏉𣘒
榴	橊𰗶
榻	㯓𢴄
槃	㮽𢱨
構	搆构
槌	桘𬄄
槍	枪𫀞
槙	槇𬃜
槠	櫧䡤
槥	檅櫘
槫	𡭐𣏢
樀	㰅𣚌
樅	枞𫞋
樓	楼樓
樕	㯈𣙙
樘	橖𣛟
樛	朻𣚉
樜	𢱋𣙃
樝	𣕈𣙁
樱	櫻𰗻
樶	𣖱𰘢
樸	朴𣝢
樺	桦椛
樾	𣙾𣜀
橃	𦪑𭩰
橏	𣜆𮃬
橘	桔𣚹
橙	枨䔲
橢	撱椭
橧	竲𧲅
橨	䒈𰗺
橼	櫞𣝵
檉	柽𢶫
檙	𣙒𪔇
檡	𣏧𰗛
檢	检検
檣	樯𰔩
檩	檁𢶸
檯	枱𣜉
檰	㰃𰘣
檵	𣠭𪲛
檽	㮕𣚐
檿	𣝓𰗜
櫍	㩫𬃊
櫓	橹櫓
櫛	栉櫛
櫝	椟䄣
櫪	𫞒𭬒
櫳	栊槞
櫺	㯪𢸲
櫻	桜樱
櫽	𨽌𬄩
欃	𣔵𣝊
欄	栏欄
欇	𣠞𪳍
權	权栦
欋	欔𪳐
欎	𢒻𣁩
欐	𪲔𬅛
欑	櫕𪴙
欛	𣠽𭭂
欸	㖑𡅅
欺	倛𠔶
歊	𣤙𭶟
歐	欧𠥷
歛	㰸𰙎
歠	𣤌𣤕
歡	欢𧆒
此	𣥅𬼘
歧	岐𣥖
歰	𣥒𰙩
殀	𣧕𣨘
殉	侚徇
殓	殮㱨
殚	勯殫
殣	𣩲𦹠
殰	㱩𦢌
殲	歼𫞔
殹	𥏏𰕉
殻	壳殻
殽	𫾼𭣷
毀	𫻻𭮳
毊	𪵑𬬤
母	𨈶⺟
毙	斃獘
毞	𣭁𪵝
毦	𣭞𨈥
毬	皳𣭳
毰	𣯱𰚢
毿	毵毶
氢	氫𣱮
氧	氱𣱢
汆	𤒪𪷚
汙	𣴰𫤿
池	𱄓𱄟
汶	渂𣶌
汽	滊𣾤
汾	𠖲𥦋
沈	瀋沈
沌	坉𣲃
沤	漚䌔
沦	淪𠗣
沩	溈潙
沬	𬐿𬜃
沮	𤅔𫨶
沼	𣳮𫥈
沾	霑𫥄
泅	汓湭
泌	毖泌
泐	𣲒𪵶
泚	𣸆𭂍
泡	𣴊𣶐
泳	𫥆𬇟
泶	澩㶅
泷	滝瀧
泸	瀘𭲬
泼	潑𣸍
泾	涇𰛟
洄	𭰁𭱫
洇	湮𭰊
洋	𣺸𭂎
洓	𣽤泍
洖	𣵗洖
洗	𣳳𬚬
洘	𣵑𪵭
洚	𣴗𣺛
洛	洜洛
洟	䶏𦳂
洦	湐𣶊
洭	㳝𣶕
洮	𣴧𫑜
洴	𣺄洴
洽	冾䨐
测	測𤂄
浛	澏𣻦
浥	裛𮖄
浴	逧𣴲
浼	凂潣
浾	泟𣵩
涊	㲽𠗋
涟	漣㦁
涡	渦濄
涨	涱漲
涬	𣷟𪶗
涯	厓漄
涴	𣹠𤷧
涺	𣲻𣶅
淈	𣽶𣿲
淊	𣵁𣵥
淜	𣳷𣻫
淠	𣴪𣹮
淢	㳼𣴤
淤	𡌧𭂔
淪	沦淪
淬	焠㳃
淭	𣖪𣸔
淮	𣼲𪶔
添	沗𣵚
渐	漸𭱤
渑	澠𡽑
渙	涣𤁊
渜	湪𫥒
渠	佢𨼽
渥	𩄌𩅵
渫	㳿𣷞
渰	𢍡𩃗
渻	𣹴𨜜
渽	溨𣴮
湉	𪶞𰑺
湙	㴒𣵉
湜	煶㵓
湯	汤漡
湱	𣶥𣼤
湾	灣𡿞
溦	霺㵟
溧	𣼆𣿚
溷	圂𢒤
溹	𭲱𭲺
滁	㶆𭳋
滂	𣶢𣹿
滅	灭㓕
滇	滇𰛬
滉	𣸿𭲄
滌	涤𣺢
滏	㵚𣺨
滤	濾𤄦
滪	澦𤂻
滫	潃𣺫
滮	𣼀𤆀
滯	滞𣻉
滱	𣸦𣻎
滲	渗㵕
滿	満满
漉	渌𣼟
漦	𣸗𣺶
漬	渍𰙴
漮	𣾩𨻷
漷	𤅝𤅻
漾	瀁𣼁
潍	濰𣻰
潑	泼溌
潔	洁𫲸
潗	淁𬄕
潜	潛濳
潟	澙舄
潤	润𪷭
潦	𣱾𰜉
潭	𤁎𤅦
潮	𣶃潮
潽	𡂈𢐾
澂	𪷁𭱾
澆	浇𪞭
澴	㶎𤁆
澹	𠸆𣽃
濂	濓𰝩
濃	浓𤅌
濆	𣸣濆
濇	𬈧𭭴
濍	𤁬𦿞
濑	瀨瀬
濔	沵𤁶
濕	湿𦒣
濙	㶈𣸨
濞	𢣦𣹮
濱	浜滨
濴	濙𬈜
瀁	𤂡𰜝
瀄	𫕝𰛤
瀅	滢灐
瀉	泻㵼
瀋	沈渖
瀍	湹𤄊
瀑	𤃵𤄗
瀘	泸𬉜
瀚	𡊺𬉥
瀝	沥𰝮
瀞	瀞瀞
瀢	濻𬉋
瀱	𣽄𤄨
瀲	潋𣾠
瀳	𣿕𰜨
瀺	𤀧𪶳
灑	洒𭳺
灒	濽𪷽
灓	𤅇𰛪
灷	𤆽灷
灼	烵𤆥
災	灾𰝸
灿	燦𪹥
炁	𤆔𪸓
炋	㶨㶪
炖	燉𤆚
炬	𤉝𥬙
烁	爍𤓈
烃	烴𤈜
烋	𤈢𬊞
烜	𤉑𤌓
烫	燙𰟡
烶	𤊟𭵬
烿	炿𭎿
焌	燇𪸘
焙	𤉮𤊷
焛	𨴙𬮟
焟	𣈏𤎳
焪	熍𣇬
焭	𦬮𬃕
焮	炘𤊑
煅	𤊳𬊷
煠	㴙𤉬
煩	烦𬊪
煪	㷕𤋃
煲	㷛𤭭
煺	㷟𤍐
煽	傓𭵚
煾	𤇯𤫹
煿	𤍿𤒔
熁	燲㶸
熂	𪸏𪸕
熆	㥺𢄍
熉	𤈶𪹢
熒	荧𪸖
熚	𤇹𤐙
熨	𣂊𤓮
熰	𣉾𬉼
熱	热𤍠
熷	𤎯𤎰
熽	𤌂𤌛
燅	𦢨𰟥
燉	炖𤍪
燶	㶶𬋔
燽	𤐭𬊍
爍	烁𭶒
爔	燨𤓚
爗	𤑻𫤨
爛	烂爛
爢	㸏𤓒
爧	燯𫞠
爩	𤓣𤓭
爫	⺤⺥
爬	𬦦𭺗
爲	为𦥮
父	𠇑⽗
爻	𤕜⽘
牆	𡫆𤛷
牍	牘𨽍
牖	牗𤗱
牘	牍𤘄
物	𣃦𰠐
牲	𰠑𰠳
牸	𭸇𮪃
牽	牵𡧷
犉	𤚮𤜃
犎	㸼𭷟
犖	荦𥕚
犟	勥𠎦
犢	犊㸿
犤	𤜑𰠹
犦	𤜈𤜌
犪	𤛽𤛾
犮	叐𡗜
状	狀𰠽
犷	獷𤣊
狍	麃麅
狠	哏很
狯	獪㹟
狹	狭𬮊
猊	貎𭸍
猍	𧳟𰡎
猒	𤟶𤠩
猕	獼𤝝
猗	䝝𭸟
猡	玀𭸰
猧	㹻𰡏
猬	蝟𧳪
猭	𦺛𧽪
猴	㺅𤠣
猶	犹𰡝
獀	𤟫𤡗
獄	狱𰡣
獐	麞𪋀
獑	𧴃𰡔
獒	獓𤢝
獜	𤡩𤢯
獡	𤡯𤢧
獢	𤢃𰡊
獨	独𰡡
獯	𪰅𭸳
獵	猎獵
獷	犷𥜟
獽	𤢢𬍀
玌	㺩㺫
玏	𤨕𤨙
玚	瑒㻛
玟	珳砇
玫	珻㺳
玭	琕𧓝
现	現𤦤
玷	㓠𭙀
珂	砢𧵛
珋	𤥌𤥗
珌	㻫𩋇
珏	玨鿑
珒	𤦯𤧎
珓	筊𥲯
珲	琿𤦳
琊	瑘𤥶
琎	璡𭢜
琖	𬍗𬍙
琦	𤦺𤨯
琨	瑻𤨾
琬	𤨰𰯭
琰	𣨬𤥎
琵	𤧰𭯋
瑀	𬍿𬎒
瑇	𣫹瑇
瑎	䃈𪟫
瑑	𤪪𪼄
瑜	𪼔瑜
瑩	莹瑩
瑫	𤦆𤨐
瑬	𡏬𤦰
瑵	𤣺𤨚
瑽	㻜𪻐
璁	𤥼𤧚
璂	𤩒𤪌
璅	𤪸璅
璋	𤨼𬔧
璎	瓔賏
璗	𬍡𮣋
璞	㺪𤩶
璟	璄𤪁
瓃	𤫤𤫥
瓅	瓑𬍛
瓒	瓉瓚
瓔	珱璎
甂	𪼺𰢳
甈	𤭝𤮅
甗	鶾𤮝
產	产𪯨
甦	𤯳𭺵
甭	甮𰢰
由	甴繇
甸	𫦝𭎧
甿	𤰡𤱂
畐	畗𤲇
畦	㽯𤳬
畫	画𬚪
畬	畭𤰩
畲	畬輋
畼	𤲘𪽈
畽	䵯𬁇
疀	𤲣𤳲
疇	畴𣋬
疊	疉𪽤
疍	𣆁𣇇
疙	𤴸𭙐
疟	𤷡𤺝
疧	𤵑𰙲
疲	㔥𠢲
痂	𦙲𦙺
症	癥㿂
痔	𤵁𤸟
痙	痉𫞬
痛	𤹯𭙡
痟	𡯩𢈭
痢	鬁痢
痩	𤶌𤸂
痯	𤻥𤼐
痷	𤹃𨂁
痿	𣨙𤸆
瘀	淤𤷠
瘁	疩𩜘
瘌	鬎𤷫
瘏	𤸭𤺈
瘕	疨𤹱
瘝	癏𤸄
瘟	温瘟
瘴	㢓𩅈
癁	𤸑𤹫
療	疗療
癈	㾱𬏦
癛	𤹄𤺡
癠	𤸾𰣬
癢	痒𤸜
癩	癞癩
癫	瘨癲
癴	癵𰣽
百	佰𦣻
皅	𡵟𦫙
皖	晥𣆿
皤	𤽻𩕏
皬	㿥𤽼
皯	𤿊𩈅
皺	皱𰤧
皾	𥀲𰤬
盋	𥁊𭽽
盒	𥁧𬾾
盕	䀀𬐛
盡	尽𡎀
盨	𥂾𪾔
眂	𥄆𥄇
眈	𧡪𪾡
眍	瞘䁱
眙	𣅿𦕲
眝	𥅖𪾣
眨	𦑯𭾣
眪	𥄞𥅙
眯	瞇𥅼
眱	𥄿𥅣
眺	覜𥆮
眽	眿𥄄
眾	𠱧𬑔
着	招着
睆	䀓𥆒
睊	睊睊
睞	睐𣍿
睢	㫿𤕚
睴	𬑕𰦅
睵	𥅤𥅰
睺	𥈑𰥱
瞀	𥈆𥎉
瞅	矁𥄨
瞍	𥈟𰦁
瞖	𪾼𬙟
瞜	䁖𧢃
瞞	瞒𥈞
瞧	睄瞧
瞫	䚓𥍗
瞯	𦠥𰥨
瞰	矙𥍓
瞶	瞆𥌶
瞸	䁋䁯
瞼	睑𥇥
矊	𥌣𬑧
矌	𥇜𭾦
矏	矈𥌗
矓	眬𥉫
矖	𥊂𰥢
矞	𥍩𥎕
矠	𥍡𥎏
矪	𥎻𦩈
矺	䂝𥐽
砊	𪿑𪿿
砎	𥐤𥔅
砑	㧎𠚾
砱	𥖟𥘃
础	礎𥗈
硁	硜䃘
硉	𡸒𥓎
硎	𥒱硎
硟	𥒔𥕈
硨	砗𨋓
硫	磂硫
硬	鞕䩕
硾	𥖌𥖴
碝	瑌礝
碟	楪𦉃
磁	礠𥔵
磈	㟴𡸖
磛	𥕌𰧫
磝	𰧑𰧜
磫	𥔧𥗦
磯	矶𡼠
磴	墱隥
磽	硗磝
礋	𥐮𰦰
礌	礧𮁋
礎	础𥕩
礒	硪𥐟
礛	礷𰧔
礩	𥕫𰧉
祃	禡𢒴
祉	祉𫲺
祋	𣪌𥙈
祚	胙𧙓
祛	佉袪
票	㶾𤊆
祰	祮禞
祲	𥛀𥛆
祼	淉𥚌
祽	𥘧𥙽
禂	䮻𩦑
禓	𥛙𰧰
禘	啻祶
禛	𥛄𥛺
禜	𥚡𰱈
禪	禅𰐹
禫	𥜯𥜸
禰	祢𥜬
禵	𣠢𰨖
禸	𥜻⽱
离	離𮂬
禽	𠎘𢄕
秀	𥝙𰨩
秆	稈𥝝
秒	䅺𥤎
秕	粃𥝓
秘	祕𤵘
秠	𥝣𥞶
秧	𥠚𬝣
秪	𥝮𥞓
秫	𥟲秫
秭	𥝱𥞑
稆	旅穞
程	呈𫹟
税	稅𨓚
稘	𥟝𥟳
稛	稇𧛃
稜	稜𥟀
稞	䴹𥠁
稡	𥞯𰨞
稦	𥟏𦸒
稯	緵𥞝
穎	颖𬱄
穙	𥣈𥣜
穡	穑𤲷
穧	𥣩𰨦
穮	𦔗𦔩
穰	壤穣
窊	溛𩂡
窎	窵𥧈
窠	窼䆼
窡	𠿡𡨤
窭	窶𮄙
竁	𡪣𬔆
竈	灶𠅾
竟	傹𧡟
竦	𢱠𢷜
竭	𫱊𰩦
竮	𥩵竮
竷	𣫡𫁯
竿	𣔼𣘠
笉	𥬜𥬿
笏	曶𡇉
笛	篴𥳤
笥	𥯱𦭡
笧	𥬰𥮫
笱	𥬉𦊒
笳	葭䈔
筁	䒼𧀍
筊	笅䉰
筘	簆𥲃
筚	篳𠢽
筝	箏𬘈
筰	𥯭𦁎
筱	𬔼𮆺
筵	𨕇𨘥
筼	篔䉙
箁	𬕃𰲄
箋	笺䇳
箑	䈉𥵳
箓	籙𥯐
箘	箟䇹
箙	𥵩𩋟
箜	𢷙𣝃
箧	篋𮎿
箪	簞𥭆
箬	篛𥮷
箯	𥲼𮩅
箹	𥬓𰩺
篃	䉋𥴔
篋	匧箧
篌	𥰉𥱌
篎	𥭝𥰚
篑	簣㙺
篙	㰏𥮑
篚	𦃄𦷁
篫	𢲿𰔧
篮	籃𢉧
篳	筚𥴂
篹	𥲻𥶊
篿	𥮔𰩮
簉	䔏𮟐
簊	𥫠𥫶
簑	𫞽𬕞
簗	𫞿𬬈
簜	𥯕𰩹
簞	箪𥲺
簡	简𬔷
簣	篑籄
簬	簵𥸐
簸	箥𤿺
簻	𥮣𰩻
籋	𥬞𥭙
籍	𥷸𫾩
籏	簱𬕗
籐	籘𰪜
籑	䉵𥶉
籓	䉒𥶋
籣	䪍𮆏
籩	笾𥸅
籫	𬖃𮆫
籬	篱𬕡
籮	箩𬖈
籴	糴䨀
粒	粒𩚷
粞	𥺗𥻏
粣	𥹣𥹤
粧	𥺁𰫁
粹	粋𥹒
粺	𥺛𥽚
糏	𣸲𪍛
糞	粪𥼢
糧	粮糧
糨	糡糨
糩	𥢶𭯅
糮	𥽏𬖮
糶	粜𱁐
糸	纟⽷
糺	𤓱𫄙
紃	𥾖𬘓
紇	纥𬼠
納	纳𤱅
紐	纽紐
紖	纼靷
紘	紭纮
紞	𥾚𬘘
紥	紮𥾱
紬	䌧䌷
紺	绀䌝
紾	𥿜𬘝
紿	緿绐
結	结𡚌
絓	𦁊𮉤
絕	绝𢇑
絙	𦀞𫄠
絛	絛𦃬
絞	绞𬗤
絢	绚𬗚
絭	𨤙𰫭
絲	丝𮈔
綅	𦃌𰬞
綌	绤𠨚
綎	𦂃𬘩
經	経经
綟	盭𫄫
綡	𦂠𫟅
綩	𥿎𬗅
綬	绶𬗾
維	维𬗿
綯	绹𦃫
綱	纲䋄
網	网𦁒
綷	紣𮉬
綽	绰𮈱
緄	绲𪹩
緅	𦁫𮉪
緉	䩫𮉧
緑	绿綠
緒	緖绪
緡	緍缗
緧	𦃈𬘶
緮	𦂊𫄭
緷	𦈉𧞢
緼	缊褞
縌	𥿬𰬳
縐	绉𦁯
縑	缣𮉈
縠	𣪺𦇍
縩	䌨𮉯
縰	𦁡𫄳
縱	縦纵
縳	䌸𦁆
縴	鏲𰬮
縷	缕縷
縹	缥𦃊
縺	𦈐𫠩
總	总𠂳
繏	𦇗𦈝
繦	繈𫄶
繭	茧𧁧
繴	𦂟𦌠
繶	𩍖𫄷
纃	緕𬘧
纆	𦄿𬙊
纊	絋纩
續	続续
纏	缠𫮸
纒	𫄖𬘉
纓	缨䋝
纗	𦆈𫄹
纟	糹⺰
纡	紆䊸
纥	紇𥾨
级	級𨸚
纩	絖纊
纪	紀𥿓
纫	紉𥾠
纶	綸𥿑
纸	紙𦀦
练	練𮉚
组	組𫃦
细	細𥿳
绊	絆𨧘
绎	繹𦆎
绑	綁𦆫
绔	絝𩊓
绖	絰𦥅
绗	絎裄
绘	繪䙡
绣	繡𰚓
绩	勣績
绫	綾𦀷
续	續𦁱
绮	綺𦂶
绯	妃緋
绱	緔鞝
绲	緄𦂬
绾	綄綰
缄	椷緘
缇	緹𫃥
缊	緼縕
缑	緱𦂐
缚	紨縛
缞	縗䙑
缡	縭褵
缤	繽𦆯
缱	繾𦇶
缲	繰鏒
缳	繯𦇏
缹	𤈒𤈣
罆	𰭄𰭆
罇	𬲝𮉶
罍	𦉩𰭇
罎	坛𦉡
罒	⺫⺲
罡	𦊆𰙧
罣	𦊱𭁹
罧	𦋗𦌀
罬	𦋖𪔒
罭	䍞𰭏
署	署𦋧
羍	𦍐𦍒
羒	𦍏𦍪
羡	羨𠿢
義	义𮊫
羬	麙𦏣
翀	𣶴𮊹
翃	翝𦐌
習	习𮊸
翙	翽𧖢
翩	𦑮𭨿
翪	𦑨𪃊
翫	䛃𠐢
翮	𦒏𮋎
翷	𦒪𪆞
耎	䎡𬻠
耏	𦓎𦓘
耒	𬂞⽾
耗	秏䚽
耙	䥯𣞻
耢	耮𥢒
耤	𦔡𦔢
耦	𥻑𫀽
耬	耧𦔪
耴	䎲𦕿
耻	恥𦔺
耿	𤓐𥄣
聆	䠲聆
聭	𩲽𬴿
聱	𤘒𦗷
聵	聩𭧫
聸	𦗯𨼈
聻	𦗚𫆏
聽	听𫧺
肌	𦠄𩨒
肓	𦘻𦙡
肕	𠯄𦨔
肗	𡜃𦘽
肙	䏍𠱮
肚	䐗𫆖
肛	㠮𤵻
肠	腸膓
肭	𦜬肭
胐	𦜇𬁹
胖	𦘱𦚓
胛	甲𩨹
胳	肐𦛃
胺	𦛅𫨥
脂	𫥉𮌖
脃	脃𰮣
脏	臟髒
脙	𤶩𦜵
脢	脄𩨿
脤	祳𦚠
脩	𠋛𢕦
脪	𤴾𦢯
脶	腡螺
脸	臉𫆤
腂	𣎈𰯬
腄	𦚥𦡘
腝	𦡃𩱄
腬	䏔𰯊
腮	顋𤸛
腯	𦝬𰯒
腰	要𦝫
腿	蹆骽
膋	膫䒿
膒	𦟾𬁵
膕	腘𩪐
膜	骳𦟦
膠	胶𦟬
膢	䄛𦝼
膩	腻𪱞
膹	𦡛𪱥
膾	脍𧸤
膿	脓𪾙
臁	𩪬𰯧
臏	膑𬛜
臗	𣎑𰯦
臠	脔𦣐
臢	臜𨤆
臨	临臨
臩	𢍴𤌮
臮	𣳻𦤌
臾	㬰𠒍
舉	举𫽛
舊	旧𫡹
舤	舧𬜒
舱	艙𤾙
舻	艫𮎗
艗	榏𦩊
艤	舣𫇣
艧	䑾𦫇
艫	舮舻
艸	𦬇⾋
芇	䒥𢁟
芍	𦯪𦱜
芝	𦭩芝
芧	杼𣏗
芨	𦳌𦳤
芫	杬𬞪
芯	𣔀𫈝
芰	茤𦼽
芽	䄰芽
苑	𨙨𫟍
苒	䒣𫇶
苔	箈菭
苘	檾䔛
苠	民𥞔
苧	薴𦬪
苵	𦸴𦼺
茅	茆𦮦
茎	莖𫇲
茑	樢蔦
茡	芓荢
茬	楂槎
茭	𦺏𦽨
茸	𦔋𦶪
荅	𮇰𰫇
荍	𫈍𮎢
荑	苐𦯔
荔	茘𦶭
荙	薘𰻗
荛	蕘𮏔
荜	蓽𦸩
荠	萕薺
荤	葷蔒
荭	葒葓
荮	葤薵
荵	𦫸𦬄
荶	䕾𫪜
莋	苲𦰼
莌	𦮀𦸍
莓	苺𦱞
莖	茎𰩼
莣	𦮤𦯌
莥	𦱙𦶆
莨	䕞𦺫
莼	蒓蓴
菀	𬜶𮏑
菁	精𰰫
菌	𮏄菌
菎	𦸫𧃣
菔	𦻉𮐐
菗	𦲥𦼾
菘	𥯆𦬘
菧	𦮈菧
菴	𫈬𫈸
菵	𦬣𦭤
菿	𦳙𦻢
萁	𦬟𧯯
萄	𦻦𫇬
萈	𦎻𦏊
萑	𦻃𦻧
萛	𦱱𦱲
萧	蕭𦘤
萩	蘒𦵒
萹	𦽟𬞤
葋	𦮿𦶔
葏	𦻄𦽷
葛	𨞛𬟦
葜	𦳴𦸉
葝	𦳲𫈎
董	蕫𦱦
葭	𦽸𫈿
葮	𦵍𦷊
葴	𣿎𦸮
蒋	蔣𠅵
蒐	獀𮫝
蒔	畤莳
蒖	𦵊𬟕
蒨	蔳𦹤
蒿	䒵𬞩
蓂	𬝫𬝬
蓄	稸𭳀
蓉	𫈅𫉘
蓋	盖𬃚
蓍	𦮂𫂓
蓏	𠆁𦽝
蓗	𦹼𮐓
蓥	鎣𨧿
蓨	蓚𮆀
蓮	莲蓮
蓱	𧁕蓱
蓸	𦿩𧅝
蓿	𦼑𰱵
蔂	蘲𦿌
蔊	䓍𦸋
蔕	𦽢𧀱
蔜	𦽠𦽺
蔟	𣙘𦺀
蔥	𦴜𧁗
蔺	藺𦻺
蔿	蒍𫇭
蕀	𧀃𮑾
蕁	荨𧂇
蕃	䮳𧂵
蕈	𦽖𧅸
蕝	蕞𫈵
蕡	𦶁𰱟
蕢	蒉𧂟
蕨	𧂱𫟔
蕪	橆芜
蕻	𦮎𦶓
蕽	𦻼𫇽
薇	𦵌𦵨
薍	𦯠𩉯
薏	𡮕𦺳
薔	蔷𧃻
薖	𨗲𰰾
薝	㢇𮑯
薞	蕵𦻂
薧	𣨻𧂎
薩	萨蕯
薲	𦿜𬝯
薴	𦺝𬞊
薵	䓓𦺚
藃	穘𰲈
藉	𧃫𮑭
藋	𧅈𧅛
藎	荩𦾗
藑	𧁰𧃜
藚	𧅎𰱐
藟	蕌蘽
藥	药葯
藶	苈𮒃
藺	蔺藺
藾	䓶𰱾
蘅	𧁠𧄇
蘆	芦蘆
蘧	𠙢𨙊
蘫	灆𬞫
蘺	蓠𧅯
蘽	櫐𣡺
蘿	萝蘿
虀	𦺅𰲅
虋	𧄸𧅾
虏	虜𱁘
虑	慮𭞐
處	処处
虖	𧆠𧆪
虘	𫊡𰲡
虛	虚𣦄
虢	𣂭𧇧
虦	虥𰲠
虩	𡄼𧈅
虪	𧇐𬟱
虬	虯𠛿
虯	𪓓𪓔
蚂	螞𧈢
蚆	𧴩𧵅
蚈	䗗蚈
蚏	𧉦𧑅
蚖	𧈮𧉗
蚮	𤱢𧊇
蚸	蝷𧈼
蚺	蚦𧊨
蚻	𧉒𧊢
蛀	𧉶𧏼
蛊	蠱𭾉
蛋	蜑𬟿
蛚	𧊿𧍼
蛛	鼄𧉿
蛜	𧉅𧊰
蛤	𧊧𬠹
蛰	蟄𧒦
蛲	蟯𧑣
蛵	𧊻𰲶
蛷	𧋛𧒔
蛾	䖸𧒎
蜐	𧉧𧋤
蜗	蝸𧎏
蜣	𧎉𧏙
蜨	𧕊蜨
蜭	蛿𧌤
蜰	𧌘𧌳
蜴	𧊤𭕏
蜷	跧踡
蜿	䖤䗕
蝉	蟬𤩧
蝓	𧊠𧍳
蝙	𧓧𮕙
蝣	䖻𧌕
蝫	蠩蝫
蝲	𢔯𬠏
蝹	蝹蝹
螀	螿𧌜
螆	𧌷螆
螇	𧋉𧕉
螔	𧏕𧓗
螚	䘅𦑴
螬	𧕐𧖤
螱	𧐇𧕈
螳	𧑽𰳇
螶	蟝𧕎
螹	𧐮𰳂
蟀	𧍓𫋔
蟄	蛰𧐨
蟅	䖨𧐚
蟆	蟇䗫
蟎	螨𬠬
蟏	蠨𧑛
蟕	𧕓𧥕
蟠	𧑪𧓙
蟡	蟡𰲲
蟣	虮𧎶
蟦	𧑈𰳊
蟱	𧓼𰲫
蟵	𧔋𬠴
蟶	蛏𬠪
蟻	蚁𡎕
蟽	𧖆𰲻
蠈	𧍡𬠠
蠉	𧑩𧔘
蠌	蚇𰲵
蠐	蛴𧏝
蠙	𧏖𧓍
蠟	蜡蠟
蠣	蛎𧓽
蠥	𧒣𧕏
蠨	蟏蟰
蠲	𧔈𩔱
血	𮕜⾎
衁	𧖬𧖭
衅	釁𮍲
衆	众𠍸
衎	𧗡𧗤
術	术𧗷
衭	㠸䊿
衲	𫀃𬡂
袋	帒𬿢
袒	襢𢅒
袠	𢊭𧙍
袤	𧝺𧞉
袨	䘩𥚎
袹	帞𫌍
袾	秼𧘣
裀	𧙊𧛑
裋	𧞀𧞫
裌	𧝯𬡒
裕	䘱𥙿
裛	𭫋𮖄
補	补𥙷
裣	襝𥜋
裤	袴褲
裫	䄗𧙮
裺	裺𰴊
裻	𧚛𧝴
裼	𫀒𬋧
褅	䙗𧝐
複	𧜰𧟞
褌	裈裩
褑	禐褤
褘	袆𫖐
褠	㡚𧛥
褥	𣯋𰚩
褧	絅𬗶
褱	𬽕𰁞
褳	裢𫠩
褷	𥛨𧚺
褼	𮂗𮖽
褽	𧛽𧜷
褿	㡟𧟔
襆	襥𭞴
襕	襴𢆄
襖	袄𧝰
襤	褴襤
襦	𧝄𮖲
襱	𧙥𰳲
襺	𧟐𧟚
覀	⻃⾑
覅	𡠍𧟰
覒	𧠑𬆾
覕	𧸈𰴕
覘	觇𮄗
覞	𧡷𧡾
覭	𪒄𬢒
覺	覚觉
覽	覧览
覿	觌𧠫
见	見⻅
觃	覎𧠐
觌	覿𮨢
觍	覥𧡝
觏	覯𧡔
觛	𧣞𨠚
觰	𧤌𧤺
觳	䐨𣫅
觶	觯𧣨
觻	𧤜𰴢
觼	𧤾𧥎
訄	訅𧥠
訉	𧥬𧥭
訊	讯𧨼
訏	𬣙𧥦
訓	训𡔠
託	侂讬
訞	𧨶𫍚
訟	讼𧧡
訧	𧥩𰵎
許	许𬐳
訹	𧧐𰵓
訽	䪷𰵛
詄	𧧲𰵙
詅	𮘿𰵚
詆	诋𬢬
詈	𧧧𧩥
詐	诈𫽏
詑	𧦭𫍡
詨	誟𰵦
詩	诗𰇝
誃	䛂𰵥
誌	鋕𰵧
誎	𧫻𬣷
誑	诳𧥶
誘	诱𬣂
誠	诚誠
誥	诰𫌲
誦	诵𭋭
誳	𧬲𫍮
誵	訤𧨪
誻	𧪟𰵸
誽	䛔𰵵
誾	訔訚
調	调調
諅	𧥽𧬔
諈	𧬡𰵶
諎	𧬢𬣾
諒	谅諒
論	论論
諝	谞𮘇
諟	惿𬤊
諠	𧩇𬤎
諡	𧨦𬢶
諣	𧬭𫍩
諥	𧬤𫍳
諹	𧩎𰵌
諻	𧫍𬤍
謄	𦫁𫆾
謈	𧬉𧭤
謉	𧫏𫍷
謌	彁𬤐
謡	謠谣
謣	𧪮𰶀
謨	谟𠻚
謬	谬𧬶
謭	谫𧪈
謰	𫌼𬣽
謱	𫍴𰵂
謲	𬢳𬤄
謳	讴𧦅
謶	𧫽𧭧
謷	謸𧭁
謼	𧫅𬤙
譁	𧪮𧮉
譅	𧬃𰶎
譇	𧬅𰶄
證	証证
譍	噟𫍑
譓	憓𬤝
譖	譛谮
識	识識
譙	谯𰟳
譜	谱𧭘
譞	𧭴𫍽
警	儆䜘
譯	訳译
譳	𧬐𰶌
譺	𧭐𬤩
譽	誉𫬁
讂	𧭦𰶍
讅	谉𬢸
讆	讏𬣀
讌	䜩𧮃
讑	𧭆𰶏
讓	让𫟝
讔	𧮐𮙊
讘	嵒𰵹
讙	𬢧𬤰
讝	𧮜𰵨
讠	訁⻈
计	計𧨻
订	訂𠄚
讣	訃赴
讨	討䚯
讫	訖𧥷
议	議𧭖
讱	訒𧮠
讲	講𧪸
讳	諱𮘪
讶	冴訝
许	許鄦
讻	訩詾
讽	諷𧩠
设	設𮘂
访	訪𧪃
诀	訣𧦾
诅	詛𥛜
诇	詗𧨝
诈	詐𧧻
诎	詘誳
诐	詖𧫸
译	譯𧬳
诗	詩𧥳
诡	詭𠱓
诧	侘詫
诨	諢𧮘
诩	詡𧩘
语	語𭭢
误	悮誤
诲	誨𠲯
诳	誑𧪴
诶	欸誒
诺	喏諾
谀	諛䛕
调	調𩋙
谇	誶譢
谎	謊𧧢
谐	諧龤
谑	謔𧫪
谓	謂𧬴
谗	讒䜛
谝	諞𧫲
谟	謨謩
谤	謗𧩂
谭	譚䜖
谮	譖𧮂
谯	樵譙
谵	譫𥕔
谶	讖䜟
豅	𧯇𰶑
豈	岂豈
豋	𧯭𧰍
豌	𧯳𰶜
豍	𧯪𧰆
豦	𤢓𮙟
豩	𤞱𧲏
豰	㺉𧲐
豷	𤡬𧴒
豻	貋𤟉
豼	𫧉𬆺
貆	狟𧳔
貈	𧲩𧴏
貎	𧳱𬥉
貏	𧳠𧳴
貘	獏㹮
貝	贝⾙
貞	贞𠨀
貢	贡𢀢
貥	蚢魧
貰	贳𧶚
貲	赀𤇬
買	买𧹒
貽	贻𰶺
賁	贲賁
賂	赂賂
賓	宾賓
賚	赉𬥦
賣	卖売
賤	賎贱
質	貭质
賴	赖𬒪
賵	赗𠙒
購	购𧶥
贆	𧷼𰷫
贇	赟𧸔
贐	赆𧶁
贓	賍𰷭
贔	赑𩖏
贖	赎𮚢
贞	貞𭾛
账	賬𧹔
贪	貪𰷄
贱	賤𧶤
贳	貰𧴹
贿	賄𧶅
赌	賭𧶴
赐	賜𧶽
赔	賠陪
赗	賵𮚐
赟	贇𰷆
赩	𦫜𦫟
赹	𧺓𧻛
趀	𧾒𨒘
趉	䞷𧻡
趙	赵𧺉
趟	䠀𢸋
趠	𧻠𪍈
趯	䢰𧾟
趱	趲䟎
趾	止䟖
跀	𧿁𧿊
跂	𩨝𰋤
跅	𧿧𨂫
跪	𧻜𨅠
踂	踙𨃆
踑	䟚𧿄
踛	𨄘𨅩
踜	𣥻𨀱
踟	跢𥇭
踡	䠰𨃪
踣	䞳䟔
踧	𨀚𨁕
踩	跴䠕
踱	𨀟𨂸
踴	𨂹𨃒
蹇	䮿𨇥
蹍	𧿸𨃨
蹑	躡𧿜
蹒	蹣𨃟
蹝	𡱦𨁾
蹡	𧽩𬧀
蹢	豴𨅙
蹦	𨁝𮛦
蹪	𨇚𰸞
蹳	𨅢𫏆
蹺	跷𮛡
躁	趮𨅶
躅	𨄃𨅛
躉	趸𧄌
躋	跻𬩣
躔	𨂷𨇠
躘	𨀁𨃸
躝	𨅬𨈆
躞	𨇾𩧟
躧	𩎉𰸐
躭	𨈣𨈨
躻	𫏮𬜖
躾	𬧧𬧬
軂	躼𬧤
軃	奲𰹀
軇	𨉔𮜶
軌	轨𧗝
軏	䡇𫐄
軑	軚轪
軒	轩𨋋
軓	𨊠𰹴
軔	轫軔
軗	𨐅𮝇
軘	𨊯𰹸
軳	𨋭𰺂
軺	轺𨍳
輀	𨎪𮝵
較	较𬧶
輆	𨌕𬨇
輈	辀𨏺
輊	轾𨏡
輕	軽轻
輘	𨌐𰺊
輛	輌辆
輜	辎𫻾
輞	辋𨊾
輠	𨍋𰺍
輡	𨍜𰺐
輢	𫐎𰹝
輦	辇輦
輨	錧𫐑
輪	轮輪
輷	𩧕𫐒
輸	输輸
輿	舆𫰀
轂	毂𩏜
轃	𨍬𰺖
轓	𨎚𰺜
轕	輵𮝺
轗	𨎕𫐘
轙	𨏢𰹵
轚	𫐁𰺟
轛	𣝉𰺃
轞	𨏊𰺗
轟	軣轰
轢	轹轢
转	轉𨍘
轴	軸𨌇
轿	轎𨎄
辂	輅𨎲
辍	輟𨌸
辐	輻𨍊
辦	办𨐾
辫	缏辮
辯	辩𨐾
迎	迊𨒖
运	運𨔪
迓	𨓃𨓴
迢	𨒄𨔴
迨	𨽿𨾃
迪	廸𨔅
迸	逬𨔧
迾	𨔜𨔭
透	䞬𬨩
逐	𢄘𰺼
逕	迳𪪯
逖	逷𨑯
通	𢓶𨓛
逞	徎𢌥
逡	𠣟𢓭
逦	邐𨘶
進	进𬯪
逿	𨗪𰺲
運	运𬦖
遏	𨔒𨔹
遐	徦𨕶
遒	逎鰌
違	违𨑕
遛	蹓𨖻
遜	逊𬎄
遡	𦞮𰻄
遣	𨕃𮚾
遮	𨖓𨖥
遶	𮞚𰺷
遷	迁𢰕
選	选𨗚
邀	撽𨖟
還	还𧽚
邏	逻邏
邐	逦𨓦
邔	𨙬邔
邛	卭𪵹
邟	𨚂𨚐
邢	郉𨚆
邩	𨚊𨚋
邬	鄔𣃶
邰	斄𰴨
邼	𨝇𰻲
邾	𫾭𬆤
郃	𪠁𮟺
郇	𨜬𨝁
郜	𨜋𬪒
郤	郄𨚥
郧	鄖䢵
部	郶𰆊
郯	𨛂𨞇
郳	𫳨𬯤
郷	𨜮𭅽
郸	鄲𨞏
郾	𨜘𬪀
郿	𨞅𮟿
鄋	𨜛𰻻
鄖	郧𨛡
鄘	𭄊𰻽
鄟	䧠𫑘
鄴	邺𨞊
鄽	𢌅𨞬
酂	酇䣜
酄	𨞂𨽧
酆	鄷𨝾
酏	𨠑𨡪
酒	𨠆𨠊
酖	𨠁𬪴
酝	醖醞
酞	䣭𨣏
酣	佄䣻
酦	醗醱
酨	𧟭𨠾
酶	䊈䤂
酹	𤁾𩛝
酺	酜𭦰
酽	醶釅
醄	𨡒𪧬
醑	𨡠𨢺
醝	𨢚𨣣
醫	医𨢒
醱	酦𨡩
醲	𨤉𬪩
醳	𨣠𰼅
醶	𨣸𫑷
醺	𨤁𮡍
醻	𨢫𨣊
釀	酿𮡌
釋	釈释
釗	钊𠟛
釛	䤢𰽖
釫	𫒑𬬨
釭	𨊧𮣲
釱	鉪𰽘
釳	𨥊𨰿
釴	𫒗𬬩
釵	钗𨥁
釿	䤺𬬱
鈃	鋞钘
鈌	𨥻𰽤
鈕	钮𮡨
鈗	䤞𫟵
鈙	鈫𫒋
鈸	钹𬫋
鈺	钰𬍟
鉎	鍟𰽫
鉒	𨭅𰽯
鉔	𨥚𫓬
鉣	𨦲𨧶
鉥	錰𬬸
鉵	𨰍𰽶
鉹	𨥌𰽹
鉼	鉼𰽼
鉾	𫓴𭿺
銅	铜𪻛
銋	鈓𰽻
銏	𫟶𮡱
銔	𨥾𬭃
銚	鋽铫
銛	銽铦
銜	衔㗸
銣	铷𨦔
銮	鑾𫒣
鋂	𨧊𰾄
鋉	𨦉𨱈
鋍	𩱚𰾀
鋗	𫓶鋗
鋙	铻𮢬
鋜	𩩔𰾃
鋝	锊𨫏
鋞	𨧑𫒝
鋣	铘𮢄
鋧	鑧𰽢
鋩	釯铓
鋬	𨥃𨧸
鋭	銳𫤛
鋼	钢龬
鋿	鏛鑜
錂	𨦎𨱋
錑	銇𬭜
錔	𨪫𰾓
錘	锤𨪰
錟	锬𬫨
錢	銭钱
錣	𨧨𮣵
錦	锦𣁙
錱	𪼉𫒕
錾	鏨鏩
鍟	𨩛𰾝
鍣	𨪓𬭡
鍧	𨰌𰾡
鍪	䥐𨩺
鍮	鋀𨱎
鍰	锾𬥢
鍲	鈱錉
鍺	锗𬫽
鍼	𨮼𰾗
鍾	钟锺
鎉	𨨹𰾬
鎒	鐞𬭦
鎘	镉𨭀
鎙	𫔈𮢮
鎚	𨮀𬭨
鎝	𨱏𫓌
鎞	𨯥𫔇
鎡	镃𨭨
鎬	镐𬞩
鎯	𨱍𩝢
鏂	𠥺𰽜
鏃	镞𨧚
鏋	𬫮𬭮
鏒	𨨕𬭝
鏚	𨭟𬭭
鏞	镛𫷵
鏤	镂𨩐
鏬	𨪬𨮡
鏸	𨫍𰾶
鏹	镪鏹
鐀	鑎𬭢
鐉	𨩸𰾼
鐋	铴𨫖
鐐	镣𬫴
鐙	镫𨮴
鐩	𨪂𬭼
鐪	鏀𫓺
鐫	𰨹𰾹
鐭	𨩬𨪎
鐴	𫓅𬭽
鐹	𰼭𰽾
鐺	铛𫟰
鐻	𨬀𮣷
鑅	𨪪𮢚
鑇	𬭉𮢕
鑊	镬𫙇
鑌	镔𨮘
鑏	𨭋𬬾
鑐	𨬗𰿂
鑛	鉱𰽚
鑣	镳𨯄
鑮	䥬𬮁
鑯	𨯒𰿈
鑱	镵𰾠
鑲	镶𬬕
鑴	䥴𫔔
钀	𨭹𰾾
钁	䦆𰽤
钂	鎲镋
钅	釒⻐
钍	釷𨦓
钖	鍚鐊
钢	鋼鎠
钤	鈐𨥩
钮	鈕㺲
铇	鉋𨥹
铊	鉈𨧯
铍	鈹鉟
铐	銬𨯕
铕	銪䥲
铖	鋮𰾔
铗	鋏𨦇
铘	鋣鎁
铠	鎧𨬫
铣	銑鍌
铦	銛𨨱
铮	錚鏳
铳	銃𥒝
铴	鐋𨧩
铻	鋙䥏
铽	鋱䥇
销	焇銷
锃	鋥䂻
锉	剉銼
锒	鋃𨨄
锖	錆䥊
锚	錨𨭈
锜	錡𨪆
锫	鉳錇
锯	鋸鐻
锾	垸鍰
锿	鎄鑀
镂	鏤𮣌
镎	釢鎿
镒	溢鎰
镘	鏝𨭜
镡	鐔𨰳
镢	鐝𰽤
镤	鏷𨮓
镧	鑭钄
镩	鑹𨭿
镬	鑊𨯟
镮	鐶𨫑
镲	鑔𨩨
镴	鑞𨭛
閂	闩𨳦
閉	闭𨳓
閎	闳𨴵
閝	𨷰𫠂
閞	㭓𫔰
閫	阃𩨫
閲	閱阅
閵	𨶄𫔴
閷	閷𰿳
閿	闅阌
闆	板𬮳
闔	阖𨵲
闖	闯𮫕
關	关𫔢
闞	阚鬫
闟	𩰙𰿻
闠	阓𨷪
问	問𠳅
闱	闈𨵾
闽	閩𨷷
阁	櫊閣
阂	閡𨵵
阅	閲𧢅
阆	閬𨶗
阇	闍𨶶
阈	閾𨵨
阋	鬩䦧
阌	閿𨳶
阍	閽𨵽
阗	闐𨳸
阘	闒𨵝
阙	闕𨵗
阚	闞𨶞
阛	闤𨷤
队	隊𨺵
阭	䦾𬮽
阼	䟭𱀈
阿	𡹣𫮄
附	坿𬛤
陇	隴𨼨
陕	陝𨹊
陞	升𪣪
陡	阧𨺗
除	𠀺𮤻
险	險𡽗
陬	𨽁𱁁
陮	𨻵𱀜
陲	𨺪𨼦
陸	陆陸
陿	𨺞𬯅
隁	𨻂𱀤
隄	碮𱀣
隈	𨺯𱀰
隍	堭墴
階	阰阶
隖	嵨𬮻
障	墇㢓
險	险険
隫	𱀡𱀳
隴	陇𨻫
隵	𱀼𱀽
隽	雋𨿇
雇	僱𬿍
雒	𨿅𩁗
雖	虽𨿽
雩	𦏻𩁹
雪	彐䨮
需	𦓔𩂉
霃	𩂷𩂸
霄	㲵䨭
霈	𬉈𬯻
霑	𩃦𮦌
霓	蛪蜺
霠	䨧𩂇
霩	𩇊𩇑
霪	䨙𩆍
霵	𩆭𩇋
霶	𩃎𩅅
霽	霁𬰁
靋	𩄞𩅩
靓	靚𩇕
非	𤤃⾮
靠	𩇸𬰜
靧	𩉓𫖃
靫	𩉠𱁿
靭	靱𪟋
靳	𪩗𫿻
靸	鞈𩎕
靼	䩢𩍕
鞈	䩡𩊆
鞏	巩𩊳
鞑	韃𩍠
鞒	鞽𩌚
鞓	䩠𭘡
鞢	𩋑𩋞
鞮	䩚䪘
鞳	𩌔𩍈
鞶	䩔𣎤
鞻	𩏝𱁺
鞽	鞒𩌡
韂	䪜𩍲
韏	𩎸𱂇
韞	韫𬰮
韫	鞰韞
韮	𦷁𬝛
韱	韯𧃖
韸	韼𩐨
頁	页⾴
順	顺𫹱
頇	顸𬱀
預	予预
領	领領
頛	𩑯𬱜
頞	𩕬𱂨
頪	𩑩𱂧
頫	䫍𫖯
願	𫖸𫹵
顛	顚颠
顣	𩖑𫖹
顦	𱂝𱂻
顧	顾𩕷
顮	𩕽𱂸
顲	𩕴𩖋
项	項𭩆
颁	攽頒
颃	頏䀪
领	袊領
颇	頗𩑼
颌	頜𦛜
颎	熲𩓺
颏	頦𩒁
颗	窠顆
颡	顙䫙
颣	纇𮨟
颤	顫𢥇
颮	飑𱂿
颯	飒𬱻
颺	飏𩗺
颼	飕𱃀
颽	𩘥𬱼
颾	𩙈𩙫
飁	𩘴𱃟
飉	𩙂𬲅
飐	颭𱃏
飑	颮𩗥
飓	颶𩗗
飖	颻䬙
飢	饥𩚌
飤	𠋡𬲦
飥	饦𪌂
飪	饪𩚽
飯	饭飯
飲	飮饮
飵	𩜅𫗢
飺	㖢𠹂
飽	饱𩝰
餘	余馀
餚	𫨖𬳁
餞	饯䬻
館	馆館
餩	餩𱃽
餭	䊗𫗮
餯	𩛾𱄄
餲	䬵𮩝
餳	饧𩛿
饀	𬳊𮩁
饆	𪍪𮩛
饈	馐𬖱
饒	饶𩜙
饗	飨𰥆
饚	𧅔𩞖
饢	馕𩟻
饣	飠⻠
饤	飣𦘭
饶	饒𰗏
馆	舘館
馌	饁𩝉
馑	饉𩞎
馞	䭯𩡒
馣	䅖𬳡
馭	驭𫘅
馯	𩡴𫘛
馾	𩣤𱄗
駊	𩢘𫘟
駏	𤝙𱅃
駐	驻𰣉
駓	䮆𬳵
駗	𩢜𱅇
駙	驸𩢇
駚	𩢥𩧫
駜	䮡𱅈
駝	驼𱄕
駡	骂𠺎
駢	騈骈
駥	𩤭𱅉
駩	騡𩧴
駪	𩣂𬳽
駭	骇𮪋
駹	𩤴𮪡
駻	馯𫘣
駽	𩢺𱅖
駾	駾𱅙
騇	𤙱𱅚
騊	𫘦𱄣
騎	骑𮪍
騕	𩡻𱅜
騠	𩤢𫘨
騧	䯄𩢍
騩	𩥢𱅡
騪	䮟𩨄
騯	𩤐𬴅
騱	𩤻𫘬
騳	𩥋𱄿
騷	騒骚
驂	骖𬳯
驈	䮇𱅫
驉	𤡣𱅧
驌	骕𩥶
驎	䮼𬴊
驒	騨𱅛
驓	𫘯𱄱
驔	𩧤𱅪
驗	験验
驞	𩦿𱅤
驟	骤𮋼
驦	騻骦
驧	𩣽𩧛
驲	馹𩡲
驵	駔𤖛
驹	邭駒
驿	驛𩦯
骃	駰𱄔
骇	駭駴
骏	駿𱄢
骗	騙𩤬
骙	騤𩦟
骚	搔騷
骢	驄𩣭
骣	驏𨄉
骦	驦𱄳
骧	驤𩦪
骨	⻣⾻
骯	肮𩨺
骺	𩩵𩩽
髅	髏䫫
髊	𩪒𩪳
髌	髕𩪯
髜	𩫆𬴛
髟	𫘹⾽
髣	𩭂𩭔
髥	𩬅𫠵
髧	𠆶𫘻
髲	𣬮𩬈
髳	䟥𨱨
髽	𩭃𩮢
鬈	𨲏𩭨
鬐	𩥂𩭰
鬔	𨲫𮫍
鬚	䰅䰑
鬟	𩯙𮫏
鬡	𨲸𮫂
鬢	鬓𫴑
鬴	𠿽𩱉
鬾	𩳣𱆟
魂	䰟𠇌
魇	魘㱘
魏	𩲈𰒕
魘	魇𭙵
魝	𠟮𬶀
魟	䱋𫚉
魤	𩵏𩵡
魭	𩵶𱇐
魮	𩹻𱇒
魱	𩵯𱇓
魾	𩶨𱇝
鮁	鲅𩵼
鮂	𫙑𱇠
鮅	𩺷𫚑
鮓	鮺鲊
鮝	鱶鲞
鮤	𩹒𫚓
鮬	𩶮𱇦
鮭	鮏鲑
鮰	𩶠𫚔
鮳	鯌鲓
鮸	𩾃𬵑
鮻	𩸌𱇳
鮾	鯘䲎
鯄	𩵍𩾁
鯉	鲤𫙣
鯒	鲬𩷛
鯔	鲻𫙩
鯨	鲸𩵙
鯮	鯼𱇾
鯷	鮷鳀
鯸	𩺟𱈄
鯹	鮏𬶢
鯼	𩼕𱈅
鰌	䲡𮬎
鰒	鳆𩺽
鰦	𩼑𫚤
鰬	𩺇𱈉
鰭	鳍𩺺
鰴	𩽚𱈑
鰹	鲣𮫹
鱇	𩾌𰯑
鱍	𩸿𱇣
鱏	𩽶𱈓
鱔	鳝䱧
鱗	鳞鱗
鱨	鲿𱈘
鱲	𫚅𫚭
鱴	𩽣𱈙
鱷	𩷜𱈚
鱸	鲈𫙔
鲃	䰾𩵒
鲅	鮁𩹏
鲇	鮎鲶
鲌	鮊𩸊
鲗	鰂䰹
鲞	鮝鯗
鲢	鰱𩽴
鲣	鰹𬵚
鲥	鰣𩶬
鲯	鯕𩵧
鲷	鮉鯛
鲼	鱝𩸂
鲿	鱨𩼝
鳇	鰉鱑
鳉	鱂𩷅
鳍	鰭𨲤
鳎	鮙鰨
鳑	鰟𩺹
鳒	鰜𩼔
鳘	鰵䲄
鳡	鱤𩹸
鳧	凫鳬
鳩	鸠𩾛
鳭	𠟀𱉈
鳳	凤𬯶
鳹	雂鵭
鳺	𨾚𱉎
鳽	𫛚鳽
鳿	𩿱𱉍
鴃	𪱖𫛞
鴄	𩿌𩿞
鴋	𨾔𪁢
鴐	𫛤𬸇
鴓	𪆮𮭤
鴝	鸜鸲
鴠	𱈣𱉗
鴡	𪂓𱉘
鴮	𨾺𫛦
鴷	䴕𨾸
鴸	𨾲𱉫
鴹	𫕿𱉯
鵅	𪃕𱉮
鵋	𪄵𱉽
鵑	鹃𨿔
鵙	𨿎𱉐
鵚	𨿖𪉍
鵛	𨿋𱉠
鵟	𨿗𫛭
鵡	鹉𬷜
鵩	𪂖𫛳
鵫	𨿧𫛱
鵬	鹏𪀢
鵳	𨿱𱊋
鵵	𨿮𱊆
鵸	𨿫𱊁
鵻	𫕜𱊅
鶚	鹗𱈽
鶛	𩀊𱊐
鶝	𪆠𱊏
鶞	𩀐𱊑
鶠	𩀀𬸘
鶡	毼鹖
鶨	𩀅𱊘
鶩	鹜𮬾
鶪	䴗𩀎
鶰	𪃰𫛫
鶳	𩿐𪄜
鶶	𩀛𱊝
鶷	𪃜𱊟
鶽	𪄩𱊛
鷁	鶂鹢
鷂	鹞𬷠
鷃	䨃𮭨
鷄	鳮䳶
鷏	鷆𱊚
鷙	鸷𬷮
鷟	𩀥𬸦
鷣	𩀽𫜃
鷥	鸶𪆓
鷧	𪆖𱊦
鷩	䨆𫜁
鷭	𩀷𬸪
鷮	𪄘𱉬
鷶	𩀺𱉳
鷸	鹬𪈄
鷾	𩁈𱊰
鷿	𩁊𬸯
鸃	䴊𱉌
鸅	𩁇𱉟
鸇	鳽鹯
鸎	䴍𬸕
鸗	𪈗𫛟
鸘	鷞鹴
鸛	鹳𮦃
鸡	雞鷄
鸣	鳴𭧘
鸧	鶬𩀞
鸫	鶇𪂝
鸬	鸕𩁨
鸯	鴦𩿶
鸳	鴛𦿲
鸵	鴕𪂊
鸷	鷙𪁊
鸸	鴯𨾿
鸹	鴰𪀅
鸼	鵃鵈
鸽	鴿䧻
鸾	鵉鸞
鹀	鵐𪂐
鹁	鵓𮬻
鹃	鵑䳌
鹄	鵠䧼
鹈	鵜𪁩
鹋	鶓𪃞
鹍	鵾𨿪
鹒	鶊𨿶
鹕	鶘𩀉
鹝	鷊䳬
鹞	鷂𩀘
鹧	鷓𪁱
鹨	鷚𪅡
鹮	䴉䴋
鹱	鸌𪇡
鹲	鸏䴌
鹵	卤⿄
麀	𪊛𪋎
麗	丽麗
麞	𪋛𪋟
麪	𪌀𮮄
麮	𪌥𱋋
黌	黉𦦴
黛	黱𩶕
黰	𪐜𪑳
黶	黡𪒞
黿	鼋𪓗
鼊	𧓄𱌉
鼜	𧒕𪔯
鼞	闣𮮫
鼲	𧳰𱌏
鼳	鼰𪕯
鼸	𪕼𱌐
鼼	𪖑𪖘
齔	龀𱌚
齖	𪘣𬹺
齗	龂𪗳
齟	龃𪗱
齡	齢龄
齤	𪙖𱌲
齬	龉𪘚
齭	𪘷𫜭
齯	𦦃𫠜
齴	𪗯𫜮
齵	𪙃𱌹
齻	𪚉𱌺
龅	齙𪗼
龇	呲齜
龎	𠩑𪠙
龏	𫲟𱍁
龑	䶮𪚔
龓	𪚞𫜲
龕	龛𪚡
龖	龘𱍂
龣	𪛓𬺠
𠁃	𠁋𥤔
𠂔	𠥽𪩲
𠆗	𠆋𠆖
𠊰	𠈕𠈥
𠌃	𢔲𢕍
𠌖	𠋕𠋸
𠎷	㒎𠑠
𠑟	𠐈𢕨
𠔯	𠌉𦴐
𠖛	𡪅𡪉
𠖫	𫤽𰃴
𠗺	𠗄𣻗
𠘥	𤅙𫥍
𠘱	𢒀𢒁
𠜲	𢵣𫥼
𠞉	𠜒𠟫
𠞮	𦞛𰄾
𠠃	㔐𠟜
𠠎	𠠛𠠰
𠠢	𠟨𠠱
𠡝	𠡔𠡢
𠦒	𠦆𰅲
𠧟	𠨅𰁐
𠩂	𠩧𠪈
𠩗	𠩦𠪗
𠬢	㞵𠬥
𠮌	𠮐𦦖
𠱛	𠜦𡖛
𠱨	𠲫𠽤
𠼝	𠼐𭊵
𠽲	𠽳𡂑
𠽽	𠹣𤕧
𠾬	𠾣𫪽
𠿕	𡁗𪜎
𡀘	𡀼𡁊
𡁉	𡂣𫫆
𡂏	𠾩𡅘
𡃤	𡂖𪢐
𡃳	𠶁𡁝
𡄤	𡃱𭈮
𡅏	𠲥𫩵
𡆩	𠕡𡇘
𡆱	𡆤𡆲
𡇶	𠚔𡇞
𡊧	𡋓𡋫
𡌦	𡔭𩇭
𡑎	𡏷𫭯
𡑻	𣗃𪳸
𡕢	𡕩𡕫
𡕧	𠅣𡕬
𡖔	𡖫𡖭
𡖪	𡌪𡖠
𡚽	侴𤣷
𡜋	𡡄𡢯
𡡕	㜧𡜆
𡢕	𡢝𡢶
𡦳	𡦲𡦴
𡧽	宺𡧬
𡨳	𡨷𡪰
𡪉	𠖛𡪬
𡪰	𡬁𡬃
𡬍	㝥𡪘
𡬘	𦒨𡬘
𡭐	𠃃𡭍
𡭾	𡮑𢉚
𡯏	𡯍𡯝
𡰌	𡰍𡰓
𡰖	𡯻𡰄
𡰾	㞖𡳠
𡴆	𡴪𡴫
𡷨	𡹑𫵸
𡸕	𡹗𰎤
𡹬	𡺩𪨹
𡼊	𡾚𡿈
𡼗	𡻆𡻇
𡾊	𡾋𡾔
𡿺	㐫𭗼
𢀜	𠦕𠦘
𢁘	𢁚𢒌
𢂤	𠀽𢂛
𢄼	𩒧𫷈
𢉩	𫨈𫨏
𢊀	𢊐𪪛
𢊃	𢉉𰏽
𢊄	𢊿𢋌
𢌱	𢌱𢌱
𢐲	𢐠𢐮
𢑥	𢑤𣉰
𢒾	𢒽𢓐
𢓜	佫臵
𢔅	徚徚
𢔣	𢔝𨔨
𢔱	𢔘𧗫
𢕂	𢔹𢕽
𢖳	𢗃𫺃
𢛆	𢙰𢠌
𢛔	𫹼𢛔
𢜪	𢞇𢢟
𢟤	𢛮𢡷
𢥠	𢥵𫹷
𢦒	𢦏𢦔
𢦚	𢦗𢦻
𢦟	𢧆𢧒
𢩘	𢩅𨑅
𢩬	𠚶𠛃
𢫷	𢪦𢬯
𢭂	㨓𢭥
𢯾	㪞𢽢
𢱣	𢰒𢳕
𢳂	𫼣𰔷
𢶒	𪭯𫿄
𢸣	𢴶𢶑
𢺄	𢹶𰔴
𢻚	𢻏𢾪
𢻵	𢂤𢼆
𢼛	敋𢼽
𢼤	敌𭇅
𢽹	敯𢾞
𢾊	𢾛𭣙
𢾑	𢻕𢾚
𢾺	𢾻𣤆
𢿵	𢿦𢿧
𣀃	𣀊𧰋
𣀆	㪊𣀄
𣀔	𣫑𥲏
𣀫	𣀯𪎘
𣀻	𣀼𫿗
𣁜	𢿕𢿜
𣁟	𢿍𣁛
𣃈	𣃑𩁥
𣃍	𣰖𣰚
𣉚	㬕𣉫
𣍐	𠊉𫧃
𣎜	𣎜𰮭
𣎟	𦠅𫞅
𣓕	㭝𣕽
𣔳	𣐼𣓣
𣗁	𥔨𥕝
𣚙	㰄𬃦
𣚠	𣠝𣡋
𣜨	𠢺𣙂
𣝆	𬅃𬅐
𣞙	𡕏𣡆
𣟌	𣟍𪴛
𣡭	𣜖𣡟
𣡶	𬃳𰘵
𣢜	𣢄𣢢
𣢲	𣢬𣢽
𣣝	𣢣𣢼
𣣲	𣢩𣤥
𣣸	𣣧𨖯
𣧖	𣦷𣧐
𣩱	𣨵𣩄
𣪘	𪠔𫏯
𣫐	𣪐𣪾
𣫠	𪃟𪆑
𣬕	𬪰𬪹
𣬹	𣭔𮋔
𣮊	𣮰𰚟
𣯼	𣰮𰚤
𣰃	𣮼𣰄
𣱐	𣱑𣱒
𣱜	𣱟𣱣
𣲾	𣳇𰛢
𣴞	𡌂𣴞
𣺰	㴥𣹝
𣻑	𭰒𣻑
𣼚	𣶞𣽯
𣿀	𪬬𪷫
𤀦	𤃏𥖍
𤁰	𣻩𤂥
𤃀	𤂰𭳬
𤄫	𤃃𤃳
𤅩	𭰥𭳻
𤈩	㷢𤏀
𤉐	𢋱𨓂
𤊴	𤌫𤎃
𤌃	𤋨𤌕
𤌌	䨍𤍧
𤎤	𫦸𬝃
𤎫	𪹝𤎫
𤑔	𤋲𤍽
𤓌	𪹠𪹰
𤔀	𤓶𤓷
𤕦	𠽽𡄉
𤕷	㸠𤕿
𤘈	𤘍𤘈
𤘸	𤙎𤚈
𤛱	𪺝𫞢
𤜁	𤛸𭭹
𤜵	𤝴𤜵
𤜾	𤜿𤞁
𤠙	㹢𭮾
𤣠	㺧𤣣
𤣨	㡫𢇋
𤤒	𤣸𤤣
𤤺	𤥟𤦥
𤥙	𤥱𤧯
𤩭	𤩩𰢖
𤫕	𤪨𤫘
𤫞	𤫖𬎞
𤫵	𦧍𦧔
𤬯	𣘞𤬰
𤮚	𤮷𤮸
𤯌	𤯍𤯎
𤯷	𤰀𦨄
𤱽	𤱁𤱉
𤲑	䍆𤱤
𤲖	𤲎𰣏
𤳖	𤳗𤳛
𤳳	𤳹𤴄
𤴙	㽰𤱐
𤴾	㾙𤷓
𤵼	𤷛𤹟
𤵽	𢈒𤸎
𤵾	𤶮𬏰
𤷀	𤶶𮨧
𤸁	㑰𠿔
𤺄	𩩳𩪪
𤻝	𤹧𰣩
𤻱	㿖𤺿
𤼌	𤺆𬌇
𥀈	𤿪𥀉
𥂫	𥂥𰤽
𥃜	𥃔𥃖
𥃤	𥄩𥆎
𥇇	𢡸𢡾
𥇗	𥇤𥇵
𥉆	𣛒𥊨
𥊣	𣦎𣦛
𥌃	𣆋𥅘
𥌛	𥊈𰦃
𥍋	䁤𪾷
𥏫	𥏲𥏻
𥕐	𥐝𥖾
𥕽	𥖗𪔑
𥗺	䃹𬒇
𥘦	𢼗𥘦
𥝈	𥝋𦦻
𥟿	𡖲𥠨
𥠄	𥟺𥡼
𥠴	𥟚𥡔
𥡅	䆁𥢐
𥢎	𥡡𥢞
𥣫	𧀅𫊕
𥥍	䆦𥥦
𥦜	𠳫𫳕
𥧥	𥧠𥨌
𥨍	㙏𡐣
𥩁	𥧗𥨴
𥪧	𥪧𥪧
𥫵	𬔲𰩬
𥭖	𥯷𩐟
𥮒	𥮓𥷰
𥯮	𥬽𥯯
𥰣	𥰤𥰷
𥱼	𦩯𦩰
𥲈	𥮩𥵥
𥲚	䉘𥵹
𥳐	𥳐𥴥
𥶓	𥰘𥷵
𥷙	𥵲𥶖
𥷼	𥳛𥷛
𥸃	𥵓𥸋
𥹄	𥹐𨤐
𥻤	𥺣𬖖
𥼶	𥽉𬖘
𥿉	𫃟𬘚
𥿯	𥾭𬘦
𥿼	𥿪𦃑
𦀉	𥿰𥿱
𦁄	𦁟𰬙
𦁉	𦁑𦂡
𦂇	𦁭𦁲
𦃘	𦆣𬘽
𦄋	𦃭𬘞
𦄍	𦆌𬘾
𦅘	繝𰬝
𦆆	𫄔𰬾
𦈨	𤭓𦈨
𦊂	䍓𦊍
𦊫	䍔𣘯
𦊴	𦊪𦊭
𦋏	䍡𦋔
𦌬	䍢𦌳
𦍙	𦍲𦍴
𦐄	䲳𨾒
𦐺	㲖𣭱
𦑣	𦑈𦑪
𦑺	𦏸𦒁
𦒂	𦐚𦑵
𦒶	𦒲𦒸
𦔔	䅼𦔨
𦙱	𦙽𦠐
𦚧	䏛𰯅
𦝨	𦞉𩩰
𦝰	䐋𣎨
𦞦	𦢽𬛎
𦟠	𦢑𰯫
𦠁	脨𭵫
𦠒	𦠑𰯖
𦠓	𠪠𦠩
𦠠	𦠀𦠔
𦠾	䐕𰮺
𦡅	𨢏𨢹
𦦧	𦦡𦧁
𦦰	𦦺𦦾
𦧈	䶖𦧎
𦧴	噒𰰆
𦨢	𦨝𦨠
𦨤	𦨬𦨺
𦪜	𦩓𦩔
𦪶	𦫆𦫈
𦪽	𦨩𦪿
𦭟	𦰜𦱆
𦭺	𦬥𦱠
𦮻	𦬾𦮌
𦯖	𦵐𦶄
𦰖	𦯏𦳹
𦰯	𤫳𰟽
𦰳	𦭿𦯙
𦳈	𦱔𦶰
𦳩	䒴𧅲
𦵟	𦱰𦳻
𦵫	𦴃𦵫
𦼫	𦸵𧃢
𦾏	𩉾𰅻
𦾵	𦴇𦽓
𧂇	𧀷𧂗
𧂒	䕴𧄝
𧂘	𧃱𧅍
𧃐	𧀿𫊛
𧄿	𧅋𧆃
𧅖	𧄞𪅐
𧅻	𧆖𧆚
𧆻	𧇉𧇡
𧇿	𧇈𧇣
𧈅	𡅗虩
𧈚	㿾𥃓
𧎵	𧏨𫊨
𧏂	𧐃𧑦
𧏺	蚼𮓹
𧏾	䘌𧈟
𧐴	𧎧𧑲
𧑄	𧈸𧑸
𧓋	𧔊𧔹
𧕟	𧉐𧕺
𧕦	𧕛𬠷
𧕲	𧔰𧕣
𧕾	𧓷𧖡
𧖁	𧓂𧕔
𧖨	𥀿𧖧
𧗃	𧗁𧗊
𧗒	𧗇𧗓
𧛒	𧜕𧜬
𧛔	𢃝𧞶
𧜁	𬡕𮂎
𧜅	𧛪𧞔
𧝉	𦂲𦅧
𧝏	𧘫𧙦
𧟨	𧟤𧟥
𧟵	𧟱𧟸
𧠞	𢽕𧠏
𧡺	𥉙𥊏
𧢆	𧡥𧡲
𧢜	𧢎𧢣
𧤏	𧤉𧥄
𧥮	𧥯𧦚
𧦝	𧦻𫍞
𧦧	𧪁𫍟
𧧆	𧨮𧪲
𧧢	詤𧧮
𧧸	𧭀𰵬
𧪘	𧭨𬢚
𧬊	𧪷𧬜
𧭹	𧮝𫍐
𧮓	𧮊𬤱
𧮫	𠴷𠶸
𧲜	𤢣𧲉
𧳟	𧳕𧳥
𧴪	𧴲𭕆
𧷎	𡑧𪠀
𧸐	𧵶𧵸
𧸪	𧸳𬥿
𧹲	㷤𧹷
𧺼	𧺲𨒤
𧻓	𧻓𧼲
𧻕	趞𧼕
𧻳	𧽂𧽴
𧼰	𧼶𨕷
𧽾	𧾬𬩊
𧾚	𨘕𰷱
𧾮	𧼍𰸀
𧾻	𧾹𧿀
𧿺	𧺐𧺙
𨀕	𧻔𧻺
𨃘	𨂓𬦩
𨅍	𨁴𨆀
𨇝	𨇧𨇲
𨇯	𨈂𰸇
𨇻	𢖥𪎓
𨊠	𨊲𰹱
𨊧	𨋝𨋷
𨊸	䢁𮝁
𨋠	𨊶𨋄
𨋢	䢂𫬶
𨋬	𨌱𫏵
𨌣	𨍅𰹎
𨌤	䡕𨍱
𨌰	䡮𬧱
𨍈	𨌘𰺔
𨍩	䡫𨏰
𨎩	輄𬨒
𨎭	𨎱𰚺
𨎶	𨌟𰹒
𨎹	𨎺𨏸
𨏈	𨍪𨏱
𨏒	𨏲𰺢
𨏥	𨏀𨐊
𨒉	䢡𨓫
𨓁	𨕧𨗙
𨔥	𨕛𨕨
𨕐	䢥𨔑
𨖱	𨘙𨘲
𨙀	𨖣𨗟
𨙸	𢻌𨙾
𨙹	𨚈𨚒
𨛶	𨜙𨟢
𨜷	𨜃𨜤
𨝍	䢴𨟦
𨞙	䢹𨞦
𨠒	䣲𨠢
𨠦	𨟿𨠈
𨡎	𨡣𮡉
𨣈	𨡺𨣜
𨣘	𨡵𨢠
𨣧	𨠨𨢞
𨣸	𨤋𬪯
𨨛	𨨑𫓼
𨨰	𨪳𨬔
𨨹	𠞈𬭞
𨪉	鍗𨪾
𨪐	𠁁𨮃
𨭚	𨮬𬭺
𨭞	𬫼𬬘
𨮔	𨮖𮡤
𨯺	𨰨𨯺
𨰠	𨰊𰿊
𨳌	𨳏𰿦
𨳚	𨳜𰿪
𨳝	䦐𨳑
𨴒	䦬𨴱
𨴯	䦠𨷼
𨵤	𨵎𬮮
𨵩	𨵷𨸆
𨷱	𨷴𨷸
𨸱	𨸨𨹌
𨹁	𨸖𨹤
𨹄	𨸳𨹃
𨻌	𨹫𨻾
𨼮	𨻴𨼧
𨽻	𥛓𫕙
𩀋	𩁃𪃉
𩂻	𱁜𱁝
𩃬	𩃛𩄈
𩄡	䨬𩆌
𩄦	𩄐𱁡
𩆂	䨏𩆃
𩆣	𩆙𩆛
𩇟	儬𩇟
𩈉	𩈊𩈌
𩉹	𩋪𩍦
𩊁	𩎝𩎺
𩋠	𩉣𩊘
𩋨	𩋟𩍏
𩌅	䩳𩌱
𩌇	䪚𩌐
𩌮	𩍽𩎇
𩎈	𩍴𩎑
𩎦	𩉤𩎔
𩏷	𥾀𫃗
𩑃	𩑄𬰺
𩒨	𪜵𫶞
𩒺	𬳗𱂩
𩓒	𩒯𩔟
𩓟	𮨌𮨚
𩓥	𩓆𫖵
𩔁	䩈𩉖
𩔶	㦄𩔷
𩕊	𩕸𬱱
𩕖	𡈣𩉃
𩖶	䫼𩖶
𩖹	𩖾𩗑
𩘚	𠑒𬰲
𩘣	𩗃𬲃
𩘻	𩙅𬲆
𩛌	䭄𫗤
𩛎	𩜠𬲴
𩛩	𩚲𩠃
𩞆	𩞐𬲪
𩞑	𩝃𩞔
𩞦	𩠏𬲜
𩞧	𩞃𱄇
𩟐	𩞱𩠅
𩡾	𩣟𩣠
𩢡	𩣀𩧬
𩢹	齨𩣅
𩣡	䮀𱅓
𩣲	𩤎𩤰
𩤺	𩢶𱄤
𩦺	𩥃𬴌
𩧚	𩢳𩣗
𩨷	𩨭𩩆
𩪣	𩪟𩪩
𩪤	𩕟𩪫
𩬢	𩫺𩬷
𩬰	𩬛𩬰
𩭺	𩯅𮫒
𩯨	𩬘𩬯
𩯰	𨲹𩬂
𩰞	䦵𩰐
𩰬	𠸲𬴳
𩱋	𩱁𩱧
𩱱	𢑎𩱢
𩱷	𩱵𱆕
𩱸	粖𥹅
𩳐	𩴔𫙉
𩳢	䄋𥚫
𩳤	𩲒𩲹
𩴑	𩳑𩴊
𩴓	𩴗𩴴
𩴪	𩴆𱆖
𩴯	𩳫𩴘
𩴱	𩴸𱆡
𩵅	𩴹𩵈
𩶅	𩵷𩶪
𩶶	鯍𩷮
𩷕	鿶䱶
𩸋	𩸇𩸖
𩸔	𠑃𭀇
𩸦	𩸧𩾆
𩹑	𩸈𩺉
𩹨	𫙨𮬙
𩹾	𩺈𱇴
𩻛	䲋𱈔
𩼔	𩼖𬶶
𩽅	𩻅𬶸
𩽝	𩺒𫙭
𩾗	鳭𨾆
𩾿	𨾝𪄇
𩿊	𦠂𱉒
𩿧	𨾪𱉜
𪀉	𪃿𬸂
𪀗	𨾼𱉭
𪁐	𪆜𬸎
𪁛	𨿒𱉷
𪁪	𨿙𪁒
𪁾	䴈𨾘
𪂛	𪃔𪃖
𪃎	𬷴𪃎
𪃐	𪃦𪃧
𪃶	䳧𪂷
𪄅	𬸌𪄅
𪄆	𪄢𪉔
𪄲	𪆡𱊥
𪄳	鿺𪍇
𪄽	𮬺𱈼
𪅏	𪄗𪆪
𪅴	𱈵𱉀
𪅿	𩀶𩁌
𪆁	𪆗𱉅
𪇄	𪄽𬸬
𪇐	𪄤𪄨
𪇑	𪈧𱉃
𪇖	𪈭𬸡
𪇗	𩁡𱈿
𪇹	𦒦𦒩
𪈐	𪈈𪈎
𪈨	𪇣𪈬
𪉿	𪉦𬸹
𪋐	𪋣𪋯
𪍑	𩚙𱋢
𪎨	䵉𠐙
𪎵	𪎸𪎹
𪎶	𪎴𪎷
𪏼	𪏾𪐁
𪐀	䵖𪏷
𪐅	䊍𥣥
𪑝	𪒃𱋷
𪑧	𪑘𪑞
𪒂	𪑥𪒇
𪓰	𪓵𫜟
𪔪	𪔤𪔧
𪕍	𪕙𪕥
𪕷	𪕸𪖃
𪖼	𪖧𪖽
𪗍	𠆜𠬎
𪗽	𪘢𬺄
𪘀	𪚏𪘀
𪘑	𪙅𱌞
𪙌	𪙇𪙑
𪙨	𪘶𪙩
𪙽	𪙪𪙱
𪚔	𪥛𬺛
𪚭	𪚵𱍅
𪛊	䇵𥭦
𪮑	𢲏𪮒
𪯚	𫸛𫸡
𪴥	𣠦𬃏
𫃧	𦅥𫃨
𫐷	𨘒𨘠
𫗧	餗𢐌
𫡰	𤾋𪜙
𬥲	𫠾𬦀
𭃀	𭃁𭞔
𭌷	𭌀𭌛
𱃡	𬲨𱃢
㐆	𠂣𡰴𭟿
㒓	㣵𠉂𠋽
㓞	𢩬𫼔𭃚
㓣	𠜪𠜼𠝘
㔶	㯯䀍𭅞
㗗	𠕩𠧅𠮠
㗼	㱉𡁖𫩤
㘝	𡆣𡆴𢬻
㛂	𡛖𡛣𡜮
㜗	𡞋𡡖𡣏
㝩	䆲𡪼𢳧
㝬	𫧚𫯤𫴂
㞷	𡉚𡴍𰙝
㟅	𡹕𡺋𡼔
㢈	㢂㢑𢈹
㣎	𢒮𤽖𧵁
㤻	𢘴𢘵𢚿
㥆	𢘶𢠮𢠻
㥟	𢚌𢞶𢠟
㥢	𢢕𪬐𫻆
㦚	𢣑𢤴𨐵
㧁	𢈊𢩓𫼒
㧟	擓㨤𢶘
㨃	𫨿𫩂𫲯
㨾	𢳌𢵇𢵎
㩶	𢲺𢹜𢺣
㪆	𢺾𢻽𢼕
㬮	𣋸𣌖𰖠
㭙	棏㰅𣚅
㮝	㮝𣒗㮝
㮮	𢲞𣚃𣝠
㮲	𣔖𰗙𰗫
㱇	𢿿𰙖𰙙
㱿	𣪊𣪎𣪗
㲉	𣪹𣫘𥀎
㴵	淧㵥𬉗
㵺	𣴪𤀥𦴝
㵾	濪𩇟𪷍
㶣	烎𤇇𭴃
㶿	𤊹𤍗𤏮
㷳	𤎝𤏚𤑤
㸬	㸽𤘱𤙍
㹊	𤙿𤛹𤜅
㺑	𤡅𤡙𬌷
㼉	𤫯𬋤𬎢
㼊	蛌𤫪𤫭
㽄	𤭣𤭦𤮓
㾷	𡳚𤶈𤷡
㿹	𤿹𥀀𰤨
䀇	𥂤𥂩𬔮
䀘	䀘𥅝𥅳
䀶	㾗䁁𥈘
䀹	䀹𥅴䀹
䁆	𥉱䁆𰥿
䁩	䏸䐳𥆐
䂔	𥏔𥏢𥏣
䃕	磱𥗞𰦷
䄻	𥟯𫀰𰨪
䅜	𥢤𥢰𮃙
䅤	𥟰𥠞𧼰
䈛	𥱙𥲖𮆖
䉞	𢶦𥴶𦽫
䉬	䕠𥳊𫂈
䉲	𥮜𥵨𥸀
䊛	䊝𥻦𰪻
䊷	䌶𪪋𫧠
䋀	𡱏𥾩𥿅
䋛	𥹫𥽲𪓋
䌥	𦅂𦈠𮈮
䌴	䌱𦇽䌴
䍦	䍠𣯤𮒭
䍽	𦍠𦏈𦏩
䎃	𦐃𦐎𦐘
䎔	䎍𦑷𦒊
䎩	䅔𤰭𦿨
䐄	𤎡𦜿𰗋
䑬	艞𦩄𦩹
䒀	䑧䑰𰰐
䓄	𦱄𦳍𦴉
䔂	𦬌𦬷𦭄
䕀	𦹔𦽣𬝺
䕅	𦶞𦺋𦾘
䕩	𧀪𧃉𧃬
䕮	𦵳𦶗𧂲
䖑	𧆽𧇅𧇻
䖙	𠥸𧇬𫇉
䗂	𧌧𧌭𧎍
䙻	𧠎𧠥𧠵
䙾	𧠉𧠜𧠡
䚕	𧢮𧢮𰴗
䚘	𧢴𧤀𧤚
䚦	𧣾𧤧𧤫
䚨	𧢿𧣘𧤔
䚮	𧥰𧦛𧦯
䛄	𧧁𧩷𫍠
䛌	䜊𬢛𰵜
䛠	𡟳𧪧𰵫
䛬	䛌𬤁𮗽
䛽	𧪗𧬿𬤌
䜉	𧩚𧬠𬤘
䜌	𤔪𮘎𰆦
䝋	𧱍𧱭𬤼
䝏	㺏𧲕𰶬
䞊	賐𧸥𧸩
䟂	𧽰𧽱𧾈
䟈	𢕂𧽮𧾞
䟡	𧿟𧿠𨀇
䟺	䟛𧿲𬦥
䠪	躖𨇔𨇰
䡟	䡶𨌦𬨌
䣘	𨝦𨞱𨟐
䣢	䎰𨝨𬪕
䥯	䎱𨰟𫔆
䥸	𨧮𨨮𬬠
䦱	𨵧𨷕𰿫
䨲	㝹𩆊𩆟
䩋	𩉌𩉑𩉚
䩞	䪓𩌓𩌤
䩺	𦃽𨎃𩉭
䪁	𩋼𩌣𩍩
䪤	𩇼𩈀𩐏
䪦	叿㖓𠲓
䪴	𩑜𩨥𫖫
䫌	𩔅𩔙𱂮
䫰	𩕔𩕶𩕼
䬅	𩗅𩘡𱃚
䬐	𡣉𩗯𱃜
䬝	䬖𩙁𩙯
䬞	𩗡𩘿𩙧
䬣	𩚋𩜐𱃱
䭈	𩛧𩜾𱄃
䭎	䭟𥻈𩝇
䭕	𩞏𩟗𬲕
䭮	𩠷𩭻𩯢
䮢	䮜𩣙𩤪
䯚	𩨴𩩓𩩼
䰇	𨲉𨲘𫙀
䰱	䚖𧢥𩵀
䰽	𩶚𩷚𱇑
䱗	𩼇𩽐𮬞
䲛	𩶡𩶶𱈛
䳅	𩿦𱈟𱉙
䳢	𨿣𪅾𫛰
䳮	𪃻𪅚𱊓
䴬	䄩𪍋𪎈
䴰	𡏜𢧇𪌙
䵖	䵛𬹔䵖
䶀	鞈鞳𪔮
万	萬𠂍𬺳
下	丅𠄟𢩹
不	不𠀚𠙐
丑	丒醜𠃠
且	𠀃𠀇𣅂
並	并並𡘋
丩	𠂈𠃏𠖬
个	個箇𬽨
丫	枒桠𬼸
串	串𠀆𰀁
丳	串串𠁷
义	羛義𬬊
之	㞢𠔇𡳿
九	玖𠔀𢌬
书	書𦘠𰭽
乳	𡲐𦜘𧲠
争	爭𠄙𠫩
互	弖㸦𢆰
亚	亞䢝𠄮
些	㱔𡭟𡭶
亞	亚亜𠀓
亢	𠕵𪜠𭂯
亨	𠅖𬽉𬽊
亭	𠅘𠅝𱅴
亿	億𠌼𠐥
仅	僅廑㝻
仇	㐜𫻲𬽦
今	仐𫝆𫢉
仍	扔𠮨𰀾
仓	仺倉𡶍
价	價㑘𠇴
伐	傠𨀳𰆭
伛	傴𢉴𤹪
伟	偉徫𠋋
伫	佇竚𨀉
伶	刢𫢕𫢣
佩	珮𠈡𧙱
侁	𢓠𢓫𫠤
侃	偘𠈉𬇡
侈	伳𠈎𣆚
供	𠇒𥫋𩛘
侥	僥儌徼
侬	儂𫣳𮜻
侹	𨉈𪨋𫧺
便	便𠊳𫢛
係	系𫯼𭛭
促	趣䟟𧻻
俎	爼𤕲𫦆
俗	𠉇𠉚𢓾
俣	俁㒁𠋼
俦	儔𠍻𡕑
俨	儼𠑊𫤌
倉	仓𫝉𰁿
個	个𠇂𮈗
倝	𠐱𣁖𨊤
借	徣藉𠎥
倪	𢞌𫢤𫢳
偆	賰䞐𠎲
健	徤𨺇𭸠
偬	傯𠏨𬾠
偷	偸媮愉
傧	儐𭀀𰌾
储	儲褚𬿜
傰	𠊵𦰿𦷛
僊	𠌐𠌔𠍍
像	像𰁼𰂸
僐	𠏜𠑫𭀒
僥	侥徺憢
僦	𠎟𫎢𰊱
僧	僧僧𰂬
僶	𠊟𥜐𬿄
僾	懓𢙸𫣊
儉	俭倹𰖲
儡	㒦𠐞𩴼
儢	𠐳𡣭𰂦
八	丷捌⼋
公	㒶𡚑𨴛
兽	獣獸𠾧
冂	冋⺆⼌
冉	冄𭁠𮉼
冷	冷𠘤𫭶
冽	𠗗𠗢𣶄
凄	恓悽淒
准	準綧𰜚
凝	冰𠘥𡷪
凡	凢凣𭂫
凹	䆟䫜𢈈
出	岀齣㞮
击	擊𠦟𢱣
刃	仭刄刃
划	劃撶𠜻
刟	𠚭𠚻𠛪
刷	㕞𠛚𢼞
剁	刴挆䤪
剈	𠛭𠜟𠜠
剕	㔈䠊𨅥
剚	倳𡸪𨧫
剞	𠚽𠜾𣂦
剸	𩠹𫦂𰄞
剾	𠛅𣂻𨫕
劓	㓷𨞳𰄩
劖	𠠤𠠥𰅈
劗	𠝩𠟒𭄛
力	力𠠲⼒
功	糼糿㓛
勃	佛㔜𠃱
勋	勲勳𠢼
動	働动𰕕
勗	𣌰𪾫𬀼
勚	勩𠡫𦘓
勩	勚𠡾𠢉
勺	杓勺勺
匋	𫧀𭅊𰅤
北	圵北北
匚	𠤬𠥓⼕
匮	匱𨙑𰅩
匿	匿𭼟𮥛
區	区𠥅𰢋
卌	𠦌𠦜𬻂
協	协𫝓𬳫
卢	盧𥃈𭾐
卬	夘𠨐𨙪
却	卻㕁𨚫
卼	𠒄𠨜𡰈
厉	厲𠪿𭙿
厕	厠廁𨕟
厘	釐𫒄𭀖
厝	庴瘄𠪞
厮	廝斯㒋
厲	厉𢋙𬒪
县	縣𡈴𬪗
叁	弎𠬄𠬅
叆	靉𨙤𮦸
口	𠙵𠮚⼝
古	𠖠𡇣𰈫
叱	𠮟𠻟叱
吊	弔𢎣𢎨
同	仝詷𧇌
名	詺䫤𭩹
吏	叓吏𠭆
吠	犻𠲎𤝜
吣	吢唚𠯟
吨	噸瓲镦
吮	𠴍𢙟𦧊
吽	呍𠴣𰠧
告	勂吿𢍎
员	員贠𪔅
呙	咼𠿎𡁑
呱	𠲐𠶩𠽿
咆	𠲅𠿙𡂘
咒	呪詋䛆
咙	嚨𠺠𡃡
咫	𣥉𦐖𰭠
咬	齩䶧𠸀
哀	𢜺𭈆𮕷
哜	嚌𠴧𠻎
哮	嘋𡦝𰍝
哳	𠹗𠻯𠽻
唁	囐𣨌𰴬
唧	喞𠷌𪡰
唸	𠿍𣣈𣣣
唾	涶𠾊𰝇
啀	嘊㹞𠺓
啈	𠵃𠶿𠷾
啓	启𭇪啓
啥	倽𠍽𠺽
啧	嘖謮㖽
啻	翅𠺏𥩶
啾	𠷘𠿈𪡧
喂	餧餵𠼊
喌	㖄𭇫𭊲
喕	𠲶𠷰𫪓
喘	歂𠽴𡄠
喣	𤆨𤉵𪹕
喾	俈嚳𡇪
嗌	𠍳𡁐𣣼
嗔	瞋謓㥲
嗝	𪢙𫬋𬴳
嗯	唔㕶𠮾
嗷	嗸熬謷
嗽	欶瘶𠻳
嘄	𡂢𫪧𭬖
嘆	叹嘆嘆
嘒	嚖暳𠽡
嘘	噓𡃧𭊌
嘤	嚶譻𭍕
嘬	𠻕𠽶𣤌
嘯	啸嘨𫪯
噍	㗹𡁻𰈭
噤	齽䫴𦧈
噭	躈𠮼𠼍
嚇	吓䓇𭮒
嚗	𠮭𡄗𥗋
嚼	𠻘𡆋𪚅
囃	囄𠱞𫝜
囒	哰𪢠𫩪
团	團揣糰
囱	囪熜𡆧
固	怘𪞎𫧡
圃	圑𡇊𬝟
圈	圏𡈕𣙢
圉	𭍤𰉑𰉓
團	团団𫸜
圞	圝𡈻𪢮
圮	嶏䤏𡺮
址	墌趾阯
坂	岅阪𪠦
坈	𡊫𡊸𫳈
坜	壢𠪖𡐰
垄	垅壟篭
垙	𤱦𤱳𨹂
垛	垜𣑧𨹄
垢	坸㻈𡊦
垦	墾𡍭𭾒
垲	塏𧯧𰊰
埒	埓浖㽟
埭	𡍖𡐡𥓏
埻	𡓑𡓣𪤯
堀	𡌷𡑥𡒈
堅	坚𡉢𡊙
堠	𡎇𪹍𭏒
堯	尧尭𫝔
堶	𡊵𤬾𤭨
塈	墍𡍳𡒖
塌	𡓲𨻇𭏕
塔	墖𩫊𱅸
墅	𤝩𤞎𤡒
墓	𡩳𫮲𭍺
墩	墪𡔋𪤯
墻	墙𫮰𫮶
墼	𡐊𡑼𡒼
壏	𡐖𡒓𰊑
壒	𡎌𡏖𭏦
壓	压圧𰉧
壔	𡑏𡑹𭎜
壘	垒壘𭻹
壜	墰墵𡐧
壢	坜𪠚𬓷
壤	壌𠧑𣩽
壯	壮𪺟𬌁
外	夘㚈𡖄
大	亣𠘲⼤
夭	殀𡕟𡰭
夹	夾袷裌
奇	畸竒𥩬
奚	𤓻𤠓𭑑
奢	奓㚛奢
奩	奁𫧗𬼵
奪	夺𡙜𰶿
奫	𡙨𣽂𫯶
奯	𡚓𫯥𫯻
妃	𡚱𡝑𡝞
妊	姙𡜟𨉃
妩	娬嫵𡣆
姬	姫㚦姬
姺	嫀㜪䢾
娋	𡜽𡡏𫱶
娕	𡠑𡣒𨃢
娟	姢𡛱𫱄
娩	㛯㝃𫰲
娴	嫺嫻𡢃
婦	妇𫳮婦
媊	𡠔𡠡𡡸
媐	𡟮𡢰𫱃
媠	嫷𡡙𫲙
媭	嬃𡡓𩒭
媲	嫓𡠌𰌒
嫈	𡠺𭩖𰌀
嫠	厘𡟋𡠉
嫡	𡡿𪯙𮉀
嫢	𡠝𡣅𫰹
嫥	𡞍𡞤𰋹
嬷	嫲嬤𡣥
嬾	嬾嬾𰌙
孌	娈𡢮𪦥
孑	𠆨𠆬𡤼
字	𡥜𥤪𫳄
孙	孫𡤾𭓂
季	𡦠𩐄𩐖
孴	𡥦𡥨𡦏
學	学𢻯𫝯
宏	厷吰宖
宕	雼𥥔𮛬
审	審谉𡩨
宥	侑𠖅𡧣
宪	憲𡩜𢝮
宬	窚𡧿𡩍
寓	庽𡪾𫴆
寘	𠖕𫴁寘
寣	𥧍𥨉𰍖
尉	叞㷉𠝋
尨	狵𡧞𢒂
尯	𡯵𣧼𥎾
尽	儘盡𥁞
屃	屓屭𡳻
屌	𠄏𡰯𨳒
屔	𡎿𡲌𢇀
屟	𡲕𡲷𡲿
山	𡶸𢇢⼭
屺	㞯𡴾𡵒
屼	𡵉𡵐𫵳
岚	嵐㞩𫵽
岨	𥕅𥥐𭖌
岫	峀䜬𥥉
岯	𡶌𨸹𨸿
峉	㟯𡾆𡿃
峡	埉峽陜
峣	嶢𡽄𰎜
峥	崝崢𡸵
崙	崘崙𪨧
崞	䧐𡾘𱀟
崦	嶖𡹛𡹮
崷	𡷾𡺚𮞹
嵐	岚嵐𡺤
嵞	𡷣𡸂𡽚
嵾	㟥㠁𡼶
嶅	㟼㠂𥂢
嶊	㠑𡽁𡽕
嶘	㟞𡸚𡺄
嶞	㟎𡺆𡽃
嶢	峣嶤𡸳
嶷	㠜𭗊𭗰
嶾	𡽸𡾯𭖷
巑	㠝𡿍𰏁
川	巛𤰏𫶧
巭	巬㠫㠬
己	𠮯𥐦⼰
巾	䘜𫋵⼱
帚	榋箒菷
帛	𪽾𬐃𬥝
帝	𠫜𠫦𢂇
常	㦂𢡭𬧿
帺	褀𢃛𧚈
幂	冖冪幎
幅	畐䋹𠥏
幔	㡢𧜞㡢
幨	裧𢃔𢅐
幰	𢁗𨏥𫷉
幺	𠂓⺓⼳
广	廣𢉭⼴
庆	慶𢙎𢝑
庛	𢈃𢉪𢊳
庤	䝰𤲔𤲵
庮	𠩚𢈞𢉷
庳	𡲎𢈷庳
康	㱂𠭳𢊪
廊	廊𪪗廊
廗	鿮𭙺𰏼
廙	廙𢇙𫷩
廟	𢉋𰍘𰤂
廬	庐廬𪪏
弇	𢍔𥦍𥦦
弈	𠅑𢌸𢌾
弛	㢮𢐋𢐏
彆	㢼𢏨𥏟
彐	⺔⺕⼹
彑	彐⺔⼹
形	𠀦𢒈形
彧	㦽𢒖𢒰
彪	𠿖𢒜𢒯
彰	章遧𰗍
很	佷狠𢓼
徐	俆𨑦𰜭
循	揗𢕀𬾱
徭	傜繇徭
徲	𢔦𢔭𰐳
忒	𢖼𢘋𫻪
忙	朚𢗅𭶿
忼	𢗟𪫤𰏔
忾	愾鎎𥎃
怐	瞉𢗕𢛑
怼	懟㦠𢥓
恂	𠣬𢞧𰃢
恟	忷𢗮𰑉
息	𡆶𢙆𧪩
恸	慟憅𢣛
恹	懕懨㦔
恻	惻𢝔𢢥
悒	邑𤶛𰇫
悬	懸𠐴𢝝
悶	闷𢛀𨴽
情	啨𢚏𰑊
惉	𢛈𢜃𢜋
惎	㥍𢗏𢤵
惟	隹𢛧𢜐
感	𢘱𢦡𫹯
愧	媿聭謉
愨	𧰕𰒍𰒘
慌	㤺慌慌
慕	𢟽𥲸𦿹
慠	㥿慠𢢡
慭	憖𫺗𭜺
慮	虑𪫰𫻖
慲	𢟮𫧥𰒆
慺	㥪𢡌慺
憋	𢠳𢢌𥡁
憎	憎憎憎
憪	𢡿𢢀𰑥
懅	𢟶𫴔𭞥
懕	𢣽𭟢𰑕
懘	𢤅𢤔𰒒
懞	蒙𭞾懞
懟	怼譵𪫼
懤	㤽㦞𣝷
懷	怀𫻡𰍓
戆	戅戇𢥨
或	㦯𢈿𢦙
戛	戞拮戛
戬	戩𢦞𭟺
房	𠩝𢨲𣃞
扈	𡴰𫝳𫨓
才	哉纔裁
托	讬𢩷𫾧
扣	釦𪫎𰒸
扩	挄擴㨯
扪	捫㨺𢪛
拎	㩕𢺰𪵍
拚	拌𢬵𢱰
招	𫾸𭛤𭠡
拨	撥𢯸𭯆
拱	廾𪭍𰓘
挂	掛罣𫭳
挃	𢯶𢰗𥡫
挖	穵𢭔𣑒
挛	攣䏈𠣈
挦	撏𠟢𢸱
挪	挼𢰓𨁌
挫	𢚂𢬕𢲖
挴	𢮇𢯈𭡡
挹	𨙰𫼷𬩴
捧	捀𢪋𭢐
捱	𢭘𨂉𫨾
掀	搟𪯱𭡓
掏	搯𣖑𰓴
接	擑𣓉𦁉
掰	擘㧳𢪘
揄	揄𢶖𤻍
揉	楺𦽩𬱅
揎	㩊𢱱𦝻
揔	惣𢭝𢷝
揖	撎𢯇𢱼
揶	捓擨歋
揸	摣𠭯𢸉
揿	搇撳𢵡
搒	挷𢮔𫢿
搣	𡟬𢳒𢷄
搥	𢮒𢱸𪯌
搩	𢫰𢳗𢷡
摄	挕撮攝
摊	擹攤𢺋
摎	樛㧃𭢢
摐	㧿𢰑𪭢
摕	𢰂𢲄𰔇
摷	㩰𦾱摷
撇	撆𣘮𣟷
撏	挦𢸧𧅩
撚	撚𢲳𭣅
撞	𢭩𨀵𫝿
撩	𢸘𢿞𰔬
撫	抚𢺌𫞶
撺	攛𢺱𰔞
擂	攂櫑𢺢
擅	𢫔𢷆𭣁
擇	択择𬙨
擊	击撃𰕕
擎	擏㢣𮬘
擘	孹擗𢹐
擦	攃𢬡𰓣
攋	揦𡓒𪮶
攏	拢𢲣𫿤
攮	搑擃𰓌
攷	𫨲𭣡𰕃
敏	勄敏敏
敔	𢻊𢾵𨨶
敗	败𭾢𰇩
敛	斂歛㪘
斆	敩斅𭯄
斓	斕𢿻𣁣
斞	斔𣂂𫿷
斡	龫𠦷𨋼
斧	𢯋𤕑𨨞
斮	𢧉𢨈𰐒
斯	𢍉𣂕𣂖
斲	䦠𨮕𨯴
方	𤙗𰲱⽅
旖	旑㫊𭥃
旚	𣄔𣄦𣄪
旟	𣄊𣄣𭤰
旬	𠣙𠣚𠣡
旭	旴晇𣅤
昜	𠃓𣆃𣆄
晁	鼂𣅬𣆷
時	时㫭𰥙
晏	曣𣇆𨴣
暂	暫蹔𣊙
暄	煊𣇥𮌻
暋	忞𢽹𭽞
暍	㬞㷎𤸎
暑	暑暑𰕾
暢	畅𣈱𬻸
暮	暯𡖶𬑤
暾	旽𣌘𰖬
曀	㙪𣌐𪾼
曌	瞾𧸵𭩇
更	㪅更𠭍
朄	𢃿𣍃𨌿
朋	倗傰𰢱
朱	硃絑𫁍
朴	樸檏𣞞
权	権權𭬳
杇	𢫸𣏓𣑀
杖	杖𨥅𭷹
杠	槓𪰄𬀒
杮	𣏕𣏟𣙿
枉	抂𢼟𣒈
枑	𣏛𣏳𣐙
果	菓𣐭𤬁
枪	槍鎗𥎄
枱	耛𨐠𬃋
枿	𣔏𣕀𭣍
柄	枋棅𥟱
柎	枎𣏘𣘧
柏	栢𬪎𭩛
柘	樜䂞𥦼
柙	㘡𣘭𫭂
柚	櫾𣟾𣠡
柝	𣔳𣝔𣟄
柠	橣檸𣜏
柢	枑楴𰟼
柱	砫𤤛𮇐
栀	卮梔𪲲
栈	棧碊𪲃
栉	扻楖櫛
栊	櫳㰍𣜐
栎	枥櫟㰛
栏	欄阑𣟬
栚	㮳㯢𣒁
校	挍𤲽𨬛
栲	𣐊𣑥𣛖
核	礉覈𣝗
桕	欍𣐤𪲈
桦	枠樺𣛛
桩	樁𣜚𦚏
桴	枹泭𣻜
桼	𣷚𩃲𭱁
梓	杍榟𥞽
梢	萷䈾䔠
梨	梸棃梨
梿	槤櫣𪐍
棕	椶㯶𣞛
棠	㭻𣙟𪳯
棧	栈桟𢯆
椢	槶簂䈐
楂	柤樝楂
楦	楥𩋢𪲩
楷	𣒉𣗀𪳠
楸	橚萩𮃚
楹	桯𣟅𬃇
概	槩槪𧜳
榕	槦穃㯴
榜	牓㮄𣑈
榝	樧𣛶𬂮
榨	搾醡𮅖
榫	笋㔼𢲜
榭	𢲌𣛘𫷺
槁	槀𩫓𭮡
槛	坎檻𣡓
槜	檇欈㰎
槟	梹檳㯽
槭	摵㰗𨇌
槮	椮𣚈𣟹
槲	㩂𣘳𥡿
槻	𡦑𬃀𭬉
横	撗橫衡
橋	桥𫞎𫞏
橑	𢄷𣟆𪴔
橤	𢣳𦁞𰘭
橱	櫉櫥𮖳
檍	𣚍𣟥𣟻
檗	柏檘蘗
檛	𥬲𨗷𭪆
檟	榎槚𬄽
檧	䈡䉥𣚜
檷	𣐐𣝧𪱾
櫋	杣𣝼𥤓
櫔	栃𣑐𣜜
櫬	榇藽𪳩
欼	㱀𠭋𣣯
欿	𣢌𣣻𣤉
殄	𣦺𣧠𣧢
殊	𠙎𡥛𡧔
殜	𣨚𣩣𣩨
殡	殯𡒨𣩵
毚	㺥𫥎𭀰
毨	𣭟𣭡𨾷
毯	㲜㲭𬇀
毻	毤𣮆𣮲
毼	𣭸𣮷𣰌
氄	𣰲𤮪𥎜
氅	𣰉𧝟𪅶
氆	𠽾𣯽𣱁
氇	氌𣰯𣱀
氿	汣㲹𣲄
汀	渟𠀩𢆊
求	㐤𡨃𥒸
汎	𪞖𪵬汎
汞	澒銾𫒎
江	𣲅𪵹𬇔
汨	漞㵋𭥚
沃	㓇𣵽𦰚
沥	瀝𤁋𤃹
沨	渢𬇺𭂒
泄	洩𣲟𣳘
泓	浤𣴦𬇗
泞	澝濘𰛑
波	溊𣴫𰃺
泦	淗𣳣𨸰
注	澍祝註
泮	冸𣳝𣴱
泺	濼㴖𤃸
洞	䆚洞𭑳
洹	𣵨𣷻𬇛
浏	嚠瀏𤄉
浑	混渾𭯹
浒	汻淲滸
浔	潯𤃂𰝐
浙	淛𣹨𰛫
浚	濬䜭𧯖
浮	㳇𢒒𣵎
涅	湼㘿𣵀
消	㴅𣱩𣱫
涝	潦澇𤏪
涣	渙𪶓𰝀
涤	滌𣼝𤂂
润	潤𣼐𰝏
淘	洮陶𭲏
淚	泪涙淚
渍	洓漬𣿙
渗	涁滲𰜄
渝	𠔡𫥓𬈝
渣	泎𥹁𬇷
港	𣽣𣿑港
湓	瓫㖹𥁳
湛	㴴𠗮𰜦
湫	湬𣹌𨺹
溅	濺𠵖𣿽
溆	漵潊㵰
溘	濭𣩱𣹆
溢	益㳑𭂚
溱	潧𣼃𬈙
溲	𣸈𦦼𬜀
滘	漖𣽸𬈯
滴	𣾌𣾪𤁷
漁	渔𣺆𭑞
漘	浱滣𫆬
漛	𪾕𬇥𬐮
漠	幕莫𥕓
漣	涟漣𬈖
漩	旋㳬𭻾
漫	澫澷𣸞
潇	瀟𤂣𤄙
潋	瀲㶑𭳮
潎	𣺲𣽠𣿁
潕	㵲𣲘𤅅
潣	湏𤀳𫞗
潴	瀦猪𤃣
潸	澘𣽽𰛚
潺	潹𠘈𣹏
澄	浧澂瀓
澜	瀾灡㳕
澤	沢泽𡘅
澨	𥱒𨼹𭲁
澳	澚𤀈𤁌
濟	济済𬈀
濩	𫉯𮑮𰝵
濾	沪滤濾
瀆	涜渎𣿦
瀡	㵦𣿂𤅵
瀶	𣻙𤂟𤄈
瀼	㶞𤅑𤅭
灞	㶚𰝚𰝲
灠	𤂺𪷃𰜐
灯	燈𤆉𧺄
灰	𤆆𦭹灰
灸	㡱𤆐𰝺
灺	炧炨𰝼
炀	煬𤋁𥠜
炜	暐煒㙔
炯	冏烱𤈍
為	为𢏽𬊓
烗	炌𤈪𤉫
烲	焎𤈱𤈴
烼	𤉄𤊺𤎲
焊	釬銲㶥
煇	辉𤑱𪸩
煙	烟𤒈𫴍
煚	燛𤌇𬋀
煤	𤊄𭳿𰟙
煴	煾熅鎾
煼	𤌝𬊂𭵇
熇	燺𤌾𤐟
熑	燫𠔨𤑙
熭	𣊄𤑒𥶬
熯	㸁𤑆𰟐
熸	𠒮𤍖𤏖
燂	𤓠𥪷𭣆
燒	烧焼𫤦
營	営营𫫎
燡	𤏵𭴐𰞇
燣	燷𤒢𬊥
燥	煰𤍜𤏟
爐	炉爐𰞭
爓	𤐞𤓁𰟘
爟	㮡𦻐𬋜
爺	爷𪺜𰂴
爾	尔𤕨𫝃
片	𢙧𬽣⽚
牒	𤗊𤗣𤗥
牛	牜⺧⽜
牟	𠫚𢃷𰠧
牬	㸬𤘬𤙂
犊	犢𤙸𤛯
犍	㸫㹇𤚳
犕	𤙳𤛟犕
犡	𤛶𤜏𤜒
犴	岸𤝪𤞿
犹	猶由𤠁
狎	䖖𠇺𧆥
狐	𤜪𦍳𧲲
狑	𤣋𤣍𤣤
狞	獰𤡺𤢆
狩	𩊦𬡁𬩨
狻	䝜𪊴𱊿
狼	狼𤠸𧳓
猘	𤝼𤟐𪘥
猜	𦞁𭛯𰡂
猝	卒𢔙𤝊
猰	䝟𤟻𤠵
猱	夒獶𧳨
獲	获雘𫉬
獸	兽𤢚𰡧
獻	献𤣉𬟫
獾	犿貛䝔
玑	璣㼄𤪫
玕	玵𤣳𤥚
玗	㺮㻀𤧙
玠	琾𡘇𤦠
玩	翫貦𣄹
玲	玲𤫩𪻖
玼	皉𤽤𭎔
珮	𤦍𤧑𰡿
琁	㺼𤥩𬍩
球	毬璆𤥲
琅	瑯𤦴𤨜
琚	𤩵𤪬𤫓
琢	琢𤥨𪼅
瑄	𤧺𪻭𪼍
瑚	鍸𤤈𥔓
瑛	英𡎘𤤠
瑳	𤧳𤨛𤪩
璉	璉𫧛𬍻
璨	㻮𭹵𭽢
環	环𤪹𬎜
璱	琗㻭𤪴
璵	玙𤪐𤫌
璽	玺𡊑𨰡
瓈	𬎙𭺊𰢎
瓜	𰢛𰰧⽠
瓤	穰𤬞𤬥
瓨	𠖵𤭊𬎥
瓴	𤬻𤮮𤮹
瓵	𤬴𤭇𤭘
甀	𣂩𦉈𪼽
甃	㼙𤬬𤭰
甄	𤭾𤮔𰴋
甍	𠪹𣞑𤭐
生	𠤵𤯓⽣
甯	宁𪧟𭓰
甹	𤲀𦥕𰀊
畇	㽦𢻸𤱬
畟	𠞅𤰯𦔎
畯	㽙𤲋𭻒
疖	癤𤻛𤻵
疗	療𤹅𤻲
疚	㝌𤶔𤶫
疛	㿒𤶡𦡴
疡	瘍𤺹𤻈
疮	瘡𤶷𤺨
痨	朥癆𭼎
痱	疿𤷂𰣱
痹	疪痺𤷒
瘅	癉𤺺𭙴
瘆	瘮𤹮𤺑
瘑	㽿𤻌𬏮
瘘	瘺瘻𤵿
瘩	㟷㾑𤺥
瘪	癟㿜𤻋
瘾	癮㽼𤻘
癞	癩㾢𢋷
癶	𠇿𣥠⽨
皂	皁𣅖𤼿
皝	皩𪾂𭽚
皭	㬭𤾽𤿃
皲	皸皹䠅
皿	𠀜𫒏⽫
盂	𥁄𬐟𬹥
盄	𥁏𥁛𥁜
盎	㼜𤬺𤭹
盛	盛𬛻𰳧
盞	盏𬐜𬐝
盦	盫𥂝𬐪
盧	卢盧𧈂
盼	聁𥌊𬑌
眇	仯𥋐𦕈
眒	𥆓𥋀𦕽
眠	𥉦𥺠𪜳
眣	眰𥄺𥈖
眦	眥䀝𥈐
眵	𥄏𥉍𭿇
眼	𥃩𥃿𥆢
睔	䎾𥇊𬑆
睘	𤲡𦊷𭾪
睟	晬𥄌𥹒
睡	𥉚𥋍𪾶
睥	睤䁹𥋑
睨	聣𥆩𧡎
瞁	㷦𤋀𦝳
瞋	䀼𥆏瞋
瞎	𥈎𰥌𰥷
瞒	瞞䐽𥊑
瞩	矚𥋛𰥩
瞭	了曢𭾙
瞷	𬑗𬛖𭧴
瞿	眗䀠𮥾
矇	蒙𥉕𬥇
矉	𪾸𭿬𮚪
矣	𠤘𡗞𢦕
知	𢇻𥎵𥎿
矬	𥏧𥲽𰦟
矰	𢎒𢨉𰦢
砈	砨𥑣𥑽
砉	𥑦𥒐𥒠
砗	硨𤥭𮁂
砚	研硯䂩
砠	岨𥕑𪂓
砣	砤碢𥓿
砮	𠪓𢊨𥑌
砰	硑𥕱𨺀
砾	礫𥓃𥕴
硷	礆鹻鹼
碎	砕𤭢𥺍
碕	埼隑𥔎
碨	𥒮𥓔𥔃
碰	掽踫䰃
磌	碵磌磌
磏	𥖝𬑻𰧧
磷	燐粦𥒣
磻	磻𥮯𦲱
礐	𥔼𥗙𬒈
礦	卝矿砿
礧	礨𡽭𥑶
礪	礪𥗠𬒪
礫	砾䃯𮁏
礬	𥖥𥖯𬒟
礿	禴𤓝𰨙
祁	𪥪𪦧𫱦
祜	𫳫𬒴𭷃
祧	𥜔𫋺𰨁
祹	𥚬𫳠𬒴
禎	祯禎𬓲
禧	熙釐𰨗
禱	祷𥜣𥜹
私	厶𥝠𰧯
秃	痜禿𣬜
积	積𥡯𥢼
秳	秮𥞸𥟴
秿	𥠵𥡨𥡵
稈	芉𦼮𦾮
稣	穌鯂䲆
種	种𥠭𫭆
稴	䆂𥠆𥻧
稵	𥠃𥣏𥣓
稿	稁稾藳
穊	穖𥝪穊
穚	𥡺𮃥𰨱
穟	𥠂𥢁𦼯
穫	耯获𮒗
穹	宆𠫙𥨟
窔	穾㝔𥤹
窞	𡩹𥦇𥧹
窣	𥤿𥦑𮄓
窬	踰𥦧𥦹
窳	𠋟𤬑𥦠
窹	𥧝𥧸𩄭
窾	窽𡪡𥧾
立	立𡗓⽴
竚	𥩟𥩽𫁢
章	暲𡈠𣁌
竢	𡱢𢈟𢉡
端	耑𥪄𰹄
競	竞𣬙𰵃
竹	𥫗⺮⽵
笋	筍𥰴𥰿
笐	𥫺𥮕𮅂
笔	筆𡭩𫂌
笝	笚䇱䈫
笞	𢰥𢲹𣘜
第	弟苐㐧
筅	箲𥬗𬕎
筌	荃𥮡𥯀
答	畗畣荅
筲	䈰𢶠𥳓
筹	梼籌𥵽
签	簽籖籤
箨	籜𥷐𮇁
範	范𥱍𫂄
篅	𥬵𥳙𦵓
篱	筣籬㰚
簢	𥴲𥵴𫂃
簫	箫簘𬕝
簾	帘簾𬖄
籀	籒籕繇
籞	𥷉𥷲𦼼
籠	笼篭籠
籯	籝𬖊𰪣
籸	籶䊁𤽰
籼	秈䄳䄽
粜	糶𥺋𥽀
粢	秶𥸷𪗉
精	䊒精𰪱
糇	餱𩛫𩝍
糍	餈𥺩𩝐
糳	𥽿𦥬𮈀
糴	籴𨤠𫃙
糷	𥻂𥽭𰫖
糹	纟⺯⺰
紀	纪紀𰫣
紙	帋纸𬘆
紟	䋮𦁌𫄛
紨	𦇁𩎠𰬅
紷	𦅫𪟹𬗪
紹	绍𢇊𬗞
終	终𡦿𫲹
絷	縶馽𡈊
絹	绢𥿕𥿻
綄	𦀸𦆼𬘫
綮	䋜䋯𦄊
綵	䌽𠗡𫃿
綾	绫綾𮈦
緀	紪𫅆𰬢
緁	𦆍𧚨𰬡
緆	𪎥𪎧𰬣
緈	𦂜𦃉𦃱
緌	𡱵𫌂𮉫
緤	𦁛𦁜𫄬
緦	缌𠅛𢇆
緵	繌𦆛𰬯
縆	絚緪𬘵
縚	𦀪𦁵𬘺
縡	𫄀𮈽𰬴
縮	缩𬓊𬛮
縻	麿䌕𥿫
縼	𢳄𦀢𰬵
縿	䪌𫃰𰬪
繂	𦆽𦆾𫄴
繐	𦅵𬘄𰬸
繑	𢄹𦃣𰬐
繓	𣠹𦄎𦈛
繘	𦇹𦈇𰬻
繩	縄绳䋲
繪	絵绘𦅩
繱	𦅢𦇎𧄉
繸	䍁𦂁𩍚
繹	绎䋇𬉖
繼	継继𫷡
纑	䋆𮉗𮉡
纚	縰𫄥𮉟
纣	紂𩋰𮧖
纭	沄紜𧶊
纱	紗𦀛𦀟
纴	紝絍䋕
纷	紛𩰏𮋤
纽	紐靵𧘥
绂	紱𥾧𥿈
绕	繞遶𡈦
绛	絳𥿸𦀮
统	侗統綂
绡	綃䌃𦂚
绵	綿緜𭘸
绸	紬綢𩋙
绹	綯𥿐𦃥
绽	綻䘺𭛮
缀	綴𦀁𧚰
缆	纜䌫𰬊
缉	緁緝𦂝
缌	緦𢆿𦃞
缏	緶𦄒𦄱
缒	硾縋䋘
缕	縷𦇆𫃵
缙	縉縉𦇢
缜	縝𣞟𦁄
缝	摓綘縫
缥	縹𦆝𦇐
缧	縲纝𦅍
缨	纓绬𰬕
缭	繚𦄗𦆖
缰	繮韁𦆊
缴	繳𥐊𦅾
缵	纂纘𩛻
罘	䍒𥦘𦊾
罠	䋋𦊞𮊄
罨	𦊸𦋙𦌌
罱	䈒𦊔𦌫
罹	罹𦌐𮊔
罻	𦌍𮊖𮊘
罼	𦌂𦌎𬙝
羅	罖罗羅
羕	𣴎𦍛羕
羟	羥𦎥𦎺
羲	𢐯𢐱𦏁
羺	𦎀𦏌𩍄
羽	羽𦏲⽻
羾	𢬀𦏺𦏼
翂	𣸜𦐈𩿈
翌	翊翼𫁩
翏	䎆𮊿𮋀
翕	歙翖𦐬
翘	翹㚁𦒒
翚	翬𦑩𫅨
翟	狄𡽢𨞩
翣	歰菨䈉
翥	䎝䬡𦑥
翦	𦑦𦑳𦒕
翭	翵𦑚𦑤
者	者者者
耇	耈耉𬚉
而	耏𰭯⽽
耐	能𡬪𩈃
耠	劐秴𦔏
耧	廔耬䅹
耶	𦔶𦕆𫆀
聋	聾䏊𤼃
职	職軄𦖱
聰	聪𰒌𰭷
聲	声𫆈𫌤
職	聀职𫟉
聾	聋聾𦗤
肐	𦘸𦙊𩨘
肒	𤼐𦘾𪐟
肢	胑𨈛𨈪
肣	𦛜𦝵𧶗
肫	𦙛𦙤𬂁
肸	肹𦙝𦜱
肾	腎𦛒𦜜
胀	痮瘬脹
胄	伷䩜𩊄
胅	䏲𦝯𩨰
胇	䏟𦕚𰮋
胈	𤕳𥥛𦙓
胎	囼孡𰮜
胔	𡥎𦙼𦚚
胙	𦙐𪱢𬆢
胪	臚㱺𥀵
胭	臙𧹢𫆣
胾	𦛹𫻯𬁱
脊	𣖷𦟝𦠗
脍	膾䭝𤺠
脔	臠臡𦟪
脚	腳踋𦛶
脛	胫𦙾𫆞
腃	㟡𡸩𦝘
腔	羫𣫝𤟄
腘	膕䐸𦛢
腥	𦎬𩤵𮩥
腩	𦝧𨡯𬛈
腱	䇟𦞬𫆩
腼	靦𣎜𥈅
膀	髈𦜅𦜶
膍	肶𭩄𰮼
膏	𥆕𭳇𮌔
膞	䏝𤮍𦝏
膰	㸋𣊩𥛮
膴	𣊲𦣌𰮇
膺	𦢖𦢻𩪠
臂	𦡍𦡜𫵔
臇	㷷䐪𣋭
臍	脐𫆷𬁼
臐	𣎰𦘶𦢜
臟	臓藏𮍄
臡	𦣊𦣚𰯋
臤	𠭃𮍍𰀡
臱	𤾜𦤔𦤝
臲	𦤞𬼯𮍝
臼	𡆥⺽⾅
舌	𢀛𦧆⾆
舔	㖭𫔗𬪴
舟	𣍝𬼊⾈
舣	檥艤𫇢
舶	艊𮎋𮎌
艇	𦨍𦨿𦪅
艎	楻𦪄𦪗
艒	䑵𦨧𦪷
艮	㫔𥃩⾉
芋	芌𦭨芋
芞	䒗𦬈𫉀
芦	蘆𦿊𧀓
芬	㞣𡴚𡵳
苇	葦𥯤𦻪
苕	芀萔𦴰
苗	𡩈𡩕𰍒
苦	瘔𡿵苦
茇	𢇷𦭞𦳺
茫	汒𣴭𰱄
茵	筃絪裀
荏	栠𦷺𬓧
荣	榮𣓳荣
荧	熒爃𭵦
荷	抲𢬲𦽅
荾	䒘𦬐𦴅
莎	𢘿𦹈𪍬
莚	葕䓷𨕇
莟	𧂃𫟓𬝓
莤	𨢲𨣡𬛮
莱	萊䒹𤲓
获	獲穫𥤙
菉	菉𦲙𦾯
菊	蘜䕮菊
菟	莵𧈋𫟏
菣	𦱽𦸃𬜤
菼	𦃖𦵹𦽉
萃	簉粹𦬡
萊	莱𦻣𪧳
萌	鋂𢡗𦹩
萐	𦱥𦵉𦾚
萤	蛍螢𧓌
营	營𢄋𰟯
萦	縈𢄋𦾵
萸	茰𦳅𦺮
落	渃落𣧳
葍	䔰𦵆𦽌
葑	湗蘴䒠
葚	椹黮𣞵
葟	䑟𤯷𦨁
葥	𦷱𦺍𧁄
葰	䕑𦶬𦹿
葺	𦱫𦲭𮏪
蒁	荗𦮠𦳯
蒂	蔕𦷾𧁏
蒜	䔉𧀂𫉑
蓘	蔉𦶧𮐀
蓝	藍𦾐𮓔
蓟	葪薊𦮯
蓬	纄莑鑝
蓲	䓵𠄾𰰤
蓼	蓼𦾷𮑹
蔘	𦲞𦷇𦼒
蔤	藌𦰷𦾖
蔪	𧀵𮅼𰱑
蔷	薔𥲞𬝶
蔹	莶蘝蘞
蔻	蔲䓻𦸅
蔼	藹𮆻𮒍
蕣	橓𦾋𧂌
蕭	萧䔥𮏒
蕳	蕑䔵𫈉
薄	䙏𦻈𫼁
薓	𣿯𧄢𮑵
薮	蓃藪𡾄
薳	䓕䕂𨘏
藁	槁𬞹𮆥
藇	𨣦𨣬𰰠
藈	𣋒𤬉𦿡
藍	蓝藍𫉶
藙	𧄘𧅙𧆈
藣	𧀛𧄾𰱯
藭	䓖𧅉𧅓
藹	蔼譪𫎽
蘀	萚𦴕𦿙
蘇	苏䒩𧃅
蘋	薲𦹗𬞟
蘬	𦺕𧁻𰰮
蘭	兰蘭𬞕
蘵	𦺿𧄕𰱲
虆	𡏱𥸕𦶖
虓	猇𧆟𧆬
虜	虏虜虜
虞	𠈌𫊣𮓥
虨	𧈇𨞹𩆱
虽	雖𧈧𨾡
蚣	蜙𧌻𧐱
蚬	蜆䗾𧖙
蛗	䘀𧌛𧒂
蛭	𧌼𧓳𬠤
蛮	蠻𧑿𧖖
蛳	螄𧋬𧏍
蛴	蠐𧓉𧖊
蜃	蜄𧒏𪓧
蜇	𧎴𧑭𧑱
蜉	𧉈𧕰𧖚
蜊	䖽䖿𧔌
蜎	蜵𫋞蜎
蜒	𧋂𧍢𧎘
蜡	蝋蠟䗶
蜥	𧌥𧌨𧎀
蜮	魊𧌒𩳠
蝇	蝿蠅𡢘
蝟	𢑭𢑯𧒞
蝥	𥓺𧍟𧒚
蝶	蜨𧋝𧋞
螝	𧊫𧏩𰳒
螭	彲𡖟𮧩
螮	蝃䗖𧋍
蟂	䳋𧒬𫋇
蟒	蠎𧎔𧏉
蟲	虫𧈰𧑉
蟷	𧒩𧒾𬠅
蠁	蚃䖮蠁
蠋	蠾䠱𧑏
蠘	䘁𧐦𧔒
衋	䀌𧗙𧗚
衝	冲𢖜𧘂
衩	紁𥘓𮕧
衫	𥘎𧛄𧟖
衬	儭襯𥘑
袁	𡊮𡋡𭎕
袄	襖𥜊𥜌
袧	𧘤𧙎𧛩
袽	䋈䘫𦀌
裏	裡裏𫟚
裓	𧚑𧛠𮖀
裡	裡𥚃𧚣
褋	𥜈𧚦𧝵
褙	禙䋳𮌡
褚	帾禇𧝙
褴	繿襤𥜓
褶	襵𢄭𧚻
褺	𧜼𧝚𬡓
襀	𧝭𫌀𮂒
襂	幓𫌄𰴂
襊	𧚥𧜮𧜱
襋	𥜕𧛘𧟜
襛	𧜆𧟒𰳺
襜	䄡䪜𧞟
襟	䘳𥘞𧛛
襬	摆䙓𧟍
襴	幱襕襽
襼	褹𬡵𰳵
見	见見⾒
覗	𥄶𫵆𬢊
覛	𧡒𧵬𫌪
觇	覘䀡䦓
览	覽𢸒𮗘
觜	𠲋𧣅𧣆
觤	䍯𧣂𩊛
觲	觪𧤱𧤻
觷	𧣔𪺔𰴣
訇	巆𠣭𧥻
訑	𧦧𧦩𫍙
訚	誾𧦸𨶡
訢	䜣𣂗𣃎
訩	哅讻𧦙
詀	譧䛸𧮪
詉	𧦨𧪅𰵠
詪	𧨛𬍊𬣳
詯	䛛𧩤𬣰
誂	𠻩𧨙𫍥
誱	啑𧪌𧫰
誷	𧦘𧧜𫍬
諄	谆𧩽𫸇
請	请請𰵕
諓	𬢣𬢥𬣡
諫	谏𧧅𫍝
諭	谕諭諭
諰	𦖷𧪳𫍰
諸	诸諸諸
諾	诺諾諾
講	讲𧪿𮗻
謟	𫍈𮘦𰵽
謴	䜇𧬪𬤆
謹	谨謹謹
謻	𠗺𧩀𰶁
譀	𧧴𧫫𰶆
譔	𧩿𧮖𬤥
譴	谴𫑍𬩠
讀	読读讀
讗	𡄴𧮄𧮋
讚	囋讃𬤮
讜	谠𧩡𧫆
讥	譏𢡧𮗸
记	記㾵𧪄
论	論𠐜𧪺
讼	訟㕬䛦
诒	詒𣣢𧦫
诟	垢訽詬
诪	譸𡃮𡆓
诫	誡䛺𧪖
说	説𧧘𧨕
诹	諏𧩞𧩻
谄	諂讇𧬦
谍	諜𧨯𧩜
谙	諳𧩸𧫧
谛	諟諦𧫚
谜	詸謎䛧
谠	譡讜𧭢
谧	謐䛑𧨨
谨	謹𧫴𧭩
谪	謫讁𧬍
谫	謭譾𪷇
谳	讞𤅊𮘾
谹	𧮯𧮴𮙎
谺	砑𧯋𧯓
谼	硔䜫𡶵
谿	磎豀𧮾
豶	獖豮𧴍
豹	犳𤝧𤞵
貀	豽𤜽𤝒
貁	𤜴𤣛𮙩
貅	㹯䝗𧲷
貒	猯𧳩𧳲
貳	贰𪱞𫎎
資	资𣣬𪶻
賈	贾賈𫌞
賢	贤𫎠𰯰
賾	赜𧷤𮥜
贈	赠贈贈
贎	𧸱𧹇𨲴
贏	赢𫎣𬚆
贕	𧸷𫧿𮚧
贩	販𧶶𧸏
贽	贄䞇𡠗
赂	賂𧸚𮙾
赅	晐賅賌
赎	贖𧸏𧹎
赏	賞贘𰠼
赚	賺𧸖𰷖
赛	賽𡧳𧶼
赠	贈𧸑𰷐
赨	𧋒𧌝𧹝
赬	赪𧹙𧹚
赶	趕𢆝𪌃
趂	𧻦𧼇𬦍
趫	𰷶𰷼𰷿
趹	䟩𨀆𫏅
趺	呋𠰵𨁜
跈	蹨䟢𨀀
跔	跼㣘𨁺
跗	趺𧿤𨁵
跟	𣥦𦚣𨁞
跱	𨂄𨃉𨃯
践	跈踐㣤
跷	蹺蹻𣦜
跽	𦜕𨃡𨄲
跾	𢞣𢢱𨁀
踊	踴𠁜𧻹
踔	趠逴𢔄
踪	蹤䢨𮜀
踳	堾𨅱𬧓
踵	歱㣫𣦟
蹁	𨆩𨆭𨇱
蹉	𨇏𩥙𫹜
蹋	躢𣥂𮛥
蹎	𧽍𨈃𰷺
蹠	跖𥔕𨂂
蹴	蹵𨇳𨉌
蹹	𨀡𨅓𨆚
躄	躃𣦢𫏂
躇	墸𣦈𣦡
躜	躦𨇃𨇇
躪	躏閵𮜩
身	𡰬𨊘⾝
車	车車⾞
軛	轭𦷖𨋜
軨	䡼䡿𫐉
軫	轸𢒨𨊨
輓	𨌔𨌜𬨈
輗	棿𨌵𫐐
輣	𨋊𨍩𰺏
輬	辌𨍡𨎅
輮	𫐓𫴀𰹢
輴	䡅𣚆𮝸
輹	𨋩𨎙𰺓
輻	辐輻𮝖
轈	𨏋𬨓𰹔
轊	䡺𨊥𫐕
轖	𩍙𩏫𰺙
轘	𨏙𭤌𮝹
轠	𨎿𨏒𫐙
轡	辔𬘍𭯮
轣	𨐀𫐆𮝬
轤	轳𨋤𨏧
轥	𨏦𨏼𰺣
轫	杒軔㭁
轳	轤䡎𩍼
辄	輒輙𮝡
辋	棢輞𨋹
辛	𣐽𨐌⾟
辥	辪𫡞𰺾
辵	辶𣥆⾡
迄	𨑐𨑵𮞂
迅	卂𨑙𨑷
迈	邁𨙗𨙚
迕	午捂𬆋
连	縺連𨘑
迣	𨑬𨒑𨓄
迫	廹敀𨒹
迮	𨕠𫸵𬆢
述	䢤𠰲𫐠
迷	粯𨒲𨶌
逆	屰𨒫𰴲
速	遬𧫷𬨮
逢	𢌢𨔔𨕱
連	连連𬨧
逮	𨓞𨗻𪮦
逶	倭𨖿𮞩
逾	踰㢏𧼯
遍	徧㴜𨖠
遑	偟皇𪪱
達	达逹𬦔
遘	𢔵𧽝𨔸
遞	递𨒾𨓝
遠	远𧽚𫟨
遹	欥𨗝𭥥
遼	辽遼𢊻
邇	趰迩𬤾
邊	边辺𫟪
邳	𨚀𨚸𨛧
郀	𨚛𨚤𨜆
郄	𠜗𨚷𨛠
郊	𨚃𨚅𨞟
郐	鄶𨞡𨞤
郑	鄭𨜟𨞀
郛	垺𡎽𡏪
郦	酈𨜥𨼓
鄑	𨝶𨟕鄑
鄗	䣗䧚𨛴
鄜	𨝧𨞻𨟤
鄝	𨝷𨝼𨟆
鄢	傿𨻳𫑚
鄦	𨝬𬪡𰻡
鄩	𨝻𨟌𬩽
鄪	𨚓𨚭𰻳
鄬	䧦𰻥𰻦
鄭	郑𬯚𬴤
鄰	邻𬖨𬖿
鄸	𨞯𨟁𨟒
鄹	郰𨝮𨞮
酈	郦𨟫𮠑
酋	𦵩𮠖𮠚
酩	佲茗𠋶
酪	嗠酪𠄇
酿	醸釀𰼃
醊	腏䄌𭿁
醐	𨠀𨠂𨡷
醛	酫𨡸𨢬
醟	蒏𦟴𨠕
醪	𨣃𫃑𮡄
醬	酱醤𨡰
釆	𠂠𤓳⾤
釉	泑𢩃𥑤
里	裏里⾥
釜	釡鬴𨥏
鈠	𥍟𨦯𨱁
鉶	铏鉶𨦿
銐	𨦙𨧳𨨬
銙	𨨆𩊓𰽴
錅	鏫鑗𨬏
錫	钖锡𬬏
録	录錄錄
鍊	錬鍊𫔀
鍋	锅𪭌𬫚
鍚	钖𩋬𬬍
鎗	鏿鑓𬬰
鎣	蓥𦹦𫒽
鏉	𢑶𢑻𨱒
鏏	𨯚𫴤𬭬
鏖	鏕㩠䥝
鏘	锵𤨿𨫥
鐯	䦃𣃈𨮿
鐸	鈬铎𫒷
鑈	鿭𨯖𨯡
鑋	𨮫𬬆𰼻
鑑	𨯿𨰹𰾫
鑘	𥤐𨯔𰿄
鑡	𨮷𬭔𮣁
鑢	䥨𬬚𮣶
鑪	鈩𬬻𰼥
鑰	钥𨷲𮯘
鑽	鑚钻𰿆
钐	釤鐥䥇
钓	釣鈟魡
钕	釢釹𫒈
钗	釵𧢷𰴠
钝	鈍䤜𫒇
钟	鈡鍾鐘
钥	鑰𫓂𰢙
钦	欽𣣽𰙓
铃	鈴鈴𬫦
铅	鈆鉛鍂
铆	鉚𨧋𮡯
铔	錏鐚𨨙
铨	硂銓𨩳
铩	鎩𨦅𨭝
银	銀𨧏𰫤
链	鍊鏈䃛
锈	銹鏥鏽
锡	錫㒪𠑳
锣	鑼𨩡𨯤
锦	錦鏱䃇
锱	錙鍿𨪲
锵	鏘𢐓𨪙
锸	鍤𨪸𨪺
锽	鍠𨨌𨪽
镖	鏢𨯺𨰐
镗	搪鏜𨲗
镛	銿鏞𨨂
镜	鏡䤳𰽟
镠	鏐𨦰𩗩
镣	鐐𨭼𰽄
镦	鐓𨰮𨰯
镫	鐙𨭕𩍐
镵	鑱䤫𨩯
門	门𨳇⾨
開	开𫔭開
間	间𬮈𰿞
閡	阂𨴢𨵏
関	关𬮦𮤋
闯	闖𨳐𨶻
闲	閑閒䦥
间	閒間𨳿
闵	湣閔𡵂
闷	悶㥃𢛩
阊	閶𨷇𨷐
阎	閻𨵻𮤥
阑	闌䦨𨷻
阡	仟圱𱀁
阨	𣲣𨸷𨹖
阪	𠭔𡊃𱀎
防	坊埅堏
阶	堦瑎階
际	際𠐐𱀮
陑	隭𨻢𨼏
陓	𨺈𨺕𱀍
院	𨺋𫕂𫕉
陰	阴𬯉𬯖
陳	陈𬯔𬯟
陴	隦𩫪𩫮
陻	垔䧈𫴄
隧	𡑞𨗅𨽛
隷	隶隸隷
隻	只𨾏𫉬
雄	厷䧺𩿅
雅	疋𤴓𬚟
雚	𮥶𮥹𮥿
雜	杂雑𮦀
雝	𩀢𬬑𬯮
雞	鶏鸡𨿸
難	难難難
雳	靂𩆝𮦷
霉	黴𪑛𫕢
霍	矐𨟓𫁒
霞	瑕赮𨲑
霿	雺𠊮𢝽
靅	𩃸𩆦𰷦
靖	靖靖𰩢
靛	淀𰍎𱁭
靥	靨𩉂𩉇
靾	𩊈𩊒𩋛
靿	𢂅𢂊𩉷
鞅	𩊟𩊧𮧕
鞎	𨋨𩊷𩎤
鞘	鞩韒𤿨
鞙	䩙䩰𩉥
韆	𩌕𩌷𱁶
韎	𣝖𩎟𫤳
韔	䩨𫸭𮧴
韝	褠𩏎𫖕
韣	韥䪅𱂋
韪	愇韙䪘
韭	韮𰞴⾲
音	𦂺𬬊⾳
韽	𩐧𪛏𱂓
頋	頋頋頋
頍	𩒩𩓗𫠆
頢	𩈙𩒲𬱠
頩	艵頩𱂦
頷	颔𩓱𱂚
頸	頚颈𩒤
頻	频頻頻
顄	𩔓𩔞𱂰
顑	䫲𠔺𱂱
顗	𡾣𫖮𮨜
顡	𩔒𩕑𩕺
顯	显顕𰐸
顿	頓𢻴𩠫
颂	頌𧨖𩔜
颅	顱髗𩔺
颈	頸𧯬𩒍
颍	潁𣻯𣾢
频	頻𩓯𩕘
题	題𧡨𧡭
颙	顒𩔔𩤛
颢	顥䯫𩓌
颥	顬䫱𩪰
颧	啳顴𩪼
颭	飐𪞲𱂽
颰	𩖮𩖽𩙥
颴	𩗟𩘶𬱽
颹	𩘚𩙃𬱵
飂	𩘷𩘸𮨵
飔	颸𩗮𪕳
飗	飀䬟𩙔
飧	飱𩚏𩛈
飼	饲飼𩚆
飾	饰𩚠𰡯
餕	馂𦿉𮩋
饃	馍𥽓𥽨
饠	𥽺𪎆𫗩
饦	飥𩟰𮨻
饭	飯飰𩚳
饲	飤飼𩚅
饾	餖䬦𮩂
馀	餘𠎳𩟳
馄	餛餫䊐
馍	饃饝𩟠
馏	塯餾𩞷
馒	饅䊡𪍩
馓	糤饊𩟴
馕	饢𧟘𩛡
馗	𠃳𡯾𦔱
馤	𩡔𩡚𩡤
馵	𩢓𮩴𱄼
馺	𢕬𩣞𱅂
馼	駇𩢌𫘜
駣	𩣛𱄞𱅏
駱	骆駱𩣥
駼	𩥽𪊸𬳿
騀	𩣣𩣨𱅗
騑	𩥰𩦎𬴂
騜	䮲𩥧𫘩
騞	𩥟𩦐𬴃
騬	𩦆𱄥𱅢
騺	駤驇𱅊
驛	駅驿𩢋
驨	𩦩𩧎𫘱
驩	𩥤𩦘𬴐
驪	骊驪𮪜
驫	骉䮶𠫑
驭	馭𩣓𩤾
驰	馳䮈𧂓
驴	驢䮫𩢉
驶	駛𩢲𩣬
驸	駙䮛𱄡
驽	駑𩢂𮛖
骁	獢驍𮪈
骄	驕䮦𱄫
骆	駱𢆇𩦼
骊	孋驪𩣫
骖	驂𩥵𮪚
骘	隲騭𨽥
骜	驁䮯𩦨
骟	騸𠞛𩦐
骫	骩骪𩨖
骭	䯎𧿂𩩃
骹	踍𨃤𩨟
髇	骹髐𩩉
髋	臗髖𦢮
髴	𠔘𨱰𩭬
髺	鬠䯺𩬁
髿	䯯𣯌𣯢
鬄	髢髰𨲎
鬉	𨲔𩭎𩮃
鬒	㐱鬒鬒
鬖	𩭹𩯑𩯟
鬞	𣰊𩯾𬴩
鬨	闀𩰓𮫔
鬩	阋𧨃𩰕
魉	魎𩗾𩳮
魖	𥛳𧴆𩴥
魚	鱼𩵋⿂
魣	𩵾𩶒𮬛
魧	𩵸𱆨𱇘
魪	䰺䱄𬶇
魫	𩵨𩵫𱇙
鮆	𩶆𩶲𫚖
鮑	蚫鲍𫙙
鮡	𩸼𩹣𬶐
鮨	䱈𩷾𮬜
鯆	𩹲𩺼𫚙
鯦	𩶧𩶿𱇼
鯻	䱨䱫𬶟
鰂	鱡鲗𱆽
鰛	鰮鰯鳁
鰟	鳑𩷸𱆸
鰥	鳏𩻄𱆾
鰿	𩼜𩼱𱇵
鱄	𧐕𫚋𱈐
鱎	䱁𩺙𱇩
鱣	鳣𱇃𱇅
鱬	𩹓𩻞𱈗
鱵	𩼘𫠍𮬤
鲏	鮍𣃣𩸉
鲑	鮭𬵐𮫽
鲟	鱏鱘𩺎
鲤	鯉𩼆𩼞
鲲	鯤𩻋𩽞
鲹	鰺𩹧𩻦
鳅	鰌鰍𩹤
鳊	鯾鯿𩼧
鳋	鰠𩷃𮬃
鳌	鰲鼇𩼡
鳔	鰾𩼾𩽯
鳠	鱯𩹹𩽕
鳥	鸟𫠓⿃
鳱	䧲𩾝𱉊
鳸	𩿇𪄮𱉓
鳻	𠝷𩿉𱉑
鴅	𫛝𬷆𬷇
鴊	𨾖𩿳𪀑
鴚	𪀁𪀉𱉕
鴛	鸳𫠔𮬫
鴢	𩾮𪀂𱉢
鴥	鴧鴪𫛣
鴰	鸹𪁝𫕛
鴱	𨿆𩾘𱉪
鵁	䴔𩾾𪁉
鵏	𨿌𪁭𬷕
鵔	鵕𨿓𱉿
鵗	𨿕𨿛𱉹
鵧	𫛨鵧𱈸
鵱	𨿲𪂚𱊀
鵽	𨿷𩿩𱊍
鶄	䴖𨿬𪂴
鶅	𨿴𪅕𱊎
鶗	鶙𪂿𫛸
鶟	𩀆𱈳𱊖
鷎	鷱𪈪𬸢
鷐	𩀭𪁧𫜀
鷑	䲯𩀩𱊢
鷒	䳪𪅘𱉏
鷕	𪂣𪄼𱊡
鷗	鴎鸥𠥹
鷛	𪅟𫛆𱊤
鷢	𩀾𪆙𱊧
鷨	𩀵𪉊𫛓
鷯	鹩𬶼𱉉
鷺	鹭鷺𪆬
鸂	㶉䳶𤄬
鸊	鷿䴙𪇊
鸍	𩁖𩿥𪈕
鸑	𩁓𪈡𬸚
鸕	鸬𩿇𪈒
鸜	𪃙𬸱𮭠
鸞	鸾鸞𬷛
鸥	鷗䳼𩀫
鸺	鵂𩾹𪀪
鹇	鷳鷴鷼
鹊	鵲䧿𩁆
鹜	鶩䳱𨾣
鹡	鶺䳭𪃹
鹦	鸚䨉𪈤
鹩	鷯䨅𬷽
鹬	鷸𨙧𪁀
鹳	雚鵍鸛
麂	𪊋𪊨𪊰
麅	𪊚𪊡𪊳
麇	麏麕𪊼
麋	麊䴢𪊏
麓	㯟𣝹𪋤
麖	𪋔𪋠𪋥
麤	𡔘𫝖𱋁
麥	麦𡖘⿆
麦	麥𡕤⻨
麳	䅘𪎂𪎌
麷	䵄𧾳𫜑
黈	𪏜𮮏𱋲
黉	黌𣍜𪏬
黏	䴴𪏹𰨶
黜	㔘𪐽𬹚
黥	剠䵞𪐛
黦	䵫𪑲𪒣
黮	𪑓𪓂𮤘
黯	𪒠𭟛𰼝
黳	𩮵𩮾𩯗
鼀	䵸𧐶𱋾
鼂	鼌𪓨𪓲
鼅	𪓳鼅𱌄
鼇	𪓴𪓶𪓾
鼏	𠕪𪔃鼏
鼒	𪔄𬁱𮮥
鼢	蚠蚡𪖅
鼨	𪔻𪔼𪕄
鼽	𪖒𪖓𪖖
鼿	齀𪖡𪖤
齌	㸄𤒱𱌗
齕	龁𪗚𪗟
齛	齥𪙚𪙥
齜	龇𪗶𪘿
齣	𫠚𮯄𱌮
齦	龈𪘄𪘎
齲	龋𪚌𰨰
齹	𪙉𪙯𬺎
齺	𪘴𪙗𱌭
齼	齭𪙀𬺓
龚	龔𡯯𭘐
𠉣	𠊽𡨳𩇇
𠑹	𠑼𠒂𧟣
𠓪	𠁭𥫧𥫮
𠛩	𠜉𠞎𤉥
𠭴	㑁𠮄𥏞
𠯑	𠮮𠯓𤯁
𠳋	𦥳𨺫𨺺
𠽸	𪡼𬱞𭈑
𡔣	𡔢𧦂𨖰
𡙐	𡘨𥆗𧡩
𡚊	𡚜𧃦𩁂
𡠗	𡠦𡡘𡣼
𡧍	𡧊𡧎𥤵
𡫬	𥨼𥩁𥩅
𡰫	𡰦𥀫𥀭
𡳭	𡳨𢾂𧖛
𡶅	𡶆𡽠𭗣
𡻱	𡻭𡿔𡿜
𡿖	𡾐𪗘𪩛
𢄌	𢟌𦃏𨨽
𢅼	㡪𢆃𢆆
𢇇	𡮟𢇂𢇅
𢊕	𢈣𢈳𢉛
𢌨	䀽𢌧𨕐
𢍚	𢍖𣓑𦳢
𢎘	𠮤𠯖𭇂
𢐗	𪫅𫹂𰐚
𢠽	偒𢡓𢢘
𢿡	𢿓𫿂𰕐
𢿧	㲂𣪼𣪿
𣀘	魗𢿟𫾳
𣂆	𣁺𣁼𰅾
𣃳	𣃰𣃴𣃷
𣆑	𣆩𣌧𰇑
𣆖	𣅇𣆬𣉪
𣛤	𣡙𣡚𧀞
𣝅	𣝆𬅃𬅐
𣟵	㰕𣛼𧕆
𣡌	𣎴𣠌𬄬
𣣳	𣣵𣤍𣤣
𣤶	𣤟𣤺𬅲
𣬸	䎄䳂𰚕
𤊲	𤇱𤋫𤎠
𤖦	𤕵𤖜𤖥
𤘼	𤘞𤘟𤙉
𤟤	𤟴𧳰𰡋
𤡢	𤢌𧴁𧴐
𤢒	𠏰𢖇𬙠
𤤄	𤥘𤥜𤥞
𤤸	㻧𤧮𰡼
𤩚	𤩮𤩯𤪢
𤮋	𤭄𤭋𤭳
𤶠	䐒𤵫𦠏
𤸱	𤷷𤸙𤹺
𤿅	皊𤾨𤾻
𥁺	𥁭𥁻𥂘
𥄉	𣐩𥄊𭾡
𥄱	昁𥄔𧠤
𥉓	𥈕𦖬𦞟
𥉹	𥇬𥊻𥍔
𥔢	䃋𥑷𥒏
𥜽	𥝁𰀒𰆇
𥞻	𥟬𥡎𥢭
𥣰	𥡐𥢈𥤍
𥦌	硦𡋱𡷟
𥫖	𥫓𥫕𨋪
𥬔	𠙴𥮱𦳰
𥳞	𥶒𥷖𦺸
𥴭	㮫䈓𮆉
𥻦	𥼆𨯓𫂿
𥽿	𥹁𥽦𪙙
𦌾	𦌶𬙪𦌾
𦒟	䎅䎔𦒂
𦥭	𦥲𦥾𦦐
𦧟	𦧞𦧱𰰉
𦧥	䑜𦧟𦧭
𦪈	𣘢𦪰𰘗
𦫶	𦫷𦭋𦱭
𦬚	𦬜𦬤𦭈
𦬢	𦬵𬻀𬻋
𦮹	𢀼𢁀𦰮
𦲯	𦯘𦱏𦱟
𦺇	䓯𥳻𦷫
𧈈	𢀊𢀋𧈊
𧈖	𧈌𧈑𧈗
𧌛	𧋰𧌓𧒙
𧐙	䖪𧎄𧎻
𧑓	𧉷𧒁𧒑
𧔞	𧉗𧏐𧕜
𧕱	𧒡𧔂𧔃
𧙧	𧙒𧙫𧙧
𧛸	𢃸𬡎𮖝
𧜣	𧚮𪀰𬡍
𧡋	𧡖𧡞𧢏
𧡸	𧡀𧢗𰴛
𧢢	𥌉𥌺𬺟
𧣚	䚥𧢺𧣏
𧦦	𠊌𧧛𰵘
𧩪	𧩓𧩟𬤋
𧫕	詧㗫𧭂
𧫢	𧨉𧩆𧭅
𧮶	𧯁𧯂𰶕
𧰻	𧱢𧲙𰶫
𧱚	𧱸𧱽𫯦
𧳙	㹭𤝽𧱇
𧸖	𧸜𰷛𰷬
𧻚	𧼉𪴶𫠱
𧻶	䟇𧻑𧼡
𧽤	𧾴𨄏𨅟
𧾂	𧽟𧽳𧾢
𨈚	𨉉𨉊𨉮
𨚶	𨚽𨛲𨛻
𨛫	𨞃𨟀𰻿
𨢋	𣫈𨢤𨣗
𨢮	䣽𨢰𨢱
𨤘	𨤚𨤝𭣏
𨥦	𨥳𨧬𬬳
𨫔	𨬇𨬝𨮲
𨬍	䤻䥦𨯝
𨷖	𨶜𨷵𫔡
𨻳	𨺆𨽑𫕄
𨿠	䳠䳯𩁅
𩌊	𧤴𩌥𩍤
𩌰	䩔𩋐𩍑
𩍓	𩌋𩏔𩏨
𩍿	䪇𩏯𩏵
𩏇	縀𩋦𩎶
𩏏	𩎩𩎯𩎴
𩑔	𩑡𩑨𫖪
𩒣	𩒥𩓒𩕅
𩓠	𩓡𩓸𩔩
𩔈	𩑿𩒕𬱭
𩔣	𩔛𩕇𱂷
𩕀	䫨𩓁𩕣
𩕲	𣄩𣄫𩔽
𩢾	䮋𩧃𩧮
𩥅	𩤂𩥓𱅣
𩥇	𩥸𩧝𩨍
𩦃	𩦔𩦴𱅘
𩫏	𩫃𩫌𩫖
𩫠	𡥹𩍯𩍷
𩭼	䯽𩬽𩭚
𩰟	𨷹𩰏𩰜
𩱘	䙐𩰻𩱝
𩲺	𩳃𩳘𩳙
𩳰	𩲺𩲼𩳋
𩵀	𩵁𩵂𱆢
𩻜	𩺾𩻯𩻿
𩾬	𩾱𪀃𪀤
𪃍	䴁𩀍𪉐
𪄉	鷛𪇉𪇛
𪅖	𪄻𪆊𬸥
𪅽	𩀿𩁀𱈻
𪆂	𩁋𪆫𪆺
𪆴	䳫𩀁𬸮
𪆹	𪁶𪃀𪇍
𪇕	䨈𧵯𪇧
𪇘	𠷎𪆇𬸍
𪇳	𪇅𪈁𪉕
𪇴	𩁝𪆆𪈛
𪈟	𪇷𪈖𪈙
𪒄	𤒭𪑎𪒐
𪒛	𪒸𪓁𪓺
𪒮	𪑍𪑣𪑩
𪔞	𪔍𪔔𪔲
𪔳	𥀼𪔕𪔢
𪕱	𪕉𪕮𪕾
𪗭	𪗬𪗵𬺀
𪗻	𪗫𪙜𬺁
𪘓	𪘡𪙄𬺇
𪘲	𪘋𪘫𬺌
𪙍	𪚂𪚈𬺏
𪚁	𪚀𪚄𱌨
𪚮	𦫉𪓚𱍄
𪚰	𤒅𪚱𱍆
𪱂	𣌁𣌂𬁑
㡅	𠕰𢄴𣆚𣍓
㣇	𡱃𢑞𧱈㣇
㣈	𠭽𠭾𠮇𨽼
㥶	𢞝𢤑𢥛𢥜
㦛	𢗓𢚎𢢎𢣟
㩻	𢻪𢼨𢼮𤿡
㯱	𣙲𣚇𣞈𣞉
㰷	𣣌𣣰𣧋𣧸
㱎	𣤿𧥊𮬓㱎
㳷	𣴵𣷤𭰞𭱓
㺜	𤡠𤣜𧴓𪺻
㼲	𤭃𤮁𦓓𰢥
㽕	㕀𡱋𣓐𣔴
㽱	㽲𤴪𤴮𤶀
㾆	𤴿𤵓𤵧𤵷
䀀	𥁔𥁩𥁷𨥧
䁙	𥅥𥈔𥍂𰥤
䁾	𥋚𧂝𬞱𰦋
䂆	𥍟𥍠𥍧𥍰
䅵	蓔𥠦𦮽𮇕
䉾	𥺘𥺟𥼠𥽑
䊊	䅏䬿𡲸𥹹
䊎	𥹳𥻖𥽊𪐂
䋽	𥀂𦂌𧛜𰬭
䌳	䌤𦂛𦇲𦇼
䎕	𦐥𦐳𦑟𦒃
䑿	𦪓𦪥𦪲𦪺
䓜	𥁼𦯫𦽘𫈞
䔺	𦳉𧁼𧄙𧅢
䖊	䖌𧆤𧆦𧆫
䘶	𢄜𧚼𧜄𫀛
䙙	𥛹𧛺𧞘𧞽
䜕	𧭡𧮇𧮏𧮚
䝁	𥢒𦺜𧰉𧰎
䞣	𧻀𧻧𧼳𮚺
䟐	𢔸𢖙𧽺𫎱
䡨	𨌅𨏇𨏜𬧹
䢆	䢇𡪮𡭃𡭋
䢱	𧾥𨗣𨙋𨙜
䤉	𨠔𨡕𨡟𨢡
䦼	𨺤𨼱𨽄𱀅
䧅	𫕇𬫶𬮓𬯐
䨥	𩀝𩆀𩆿𩇈
䩸	䇀𩉪𩊐𩍮
䫀	𩑡𩒝𩓓𫖱
䫏	魌䫑𠐾𬱦
䫠	𩓄𩓭𩔌𬱰
䬟	𩗌𩗩𩙗𱃙
䭉	𩞢𩟆𪍳𬳅
䭐	䬺䭥𩜣𩞭
䰓	𨲛𨲾𩮇𩯠
䱡	𧅹𩼥𩽘𱇽
䲊	𩷷𩼂𩼏𩼐
䳕	𨿚𪃽𮬻𱉺
䳚	鳱𨿑𱈫𱉶
䳷	𩀨𩀰𪅜𱁋
䴚	𨟼𪉛𪉡𮭰
䴾	𪍙𪍰𪎀𱋧
䵴	𪒎𪓱𫜙𫜞
䶎	𪖗𪖝𪖨𪖲
䶛	𪗿𪘼𪙂𪙷
䶥	𪙁𪙾𱌢𱌧
䶩	𪘱𪙔𪙘𪚎
䶬	𪚒𪚜𪚟𱌿
丕	㔻𠦓𫠭𫫘
业	業㸣𢄁𤎸
丝	糸絲銯𢇁
久	乆镹𠆥𫝄
乌	恶烏𥾪𰠺
乏	𠂜𠓟𣥄𬔝
乔	喬𠂚𠳮𡗘
乡	郷鄉鄕𭅼
于	亏亐於𠂌
五	伍㐅𠄡𫝀
亵	暬褻䙝𮒸
介	𡗟𡗦𡗲𫳶
仑	侖𠌈𠎚𠔕
以	已㕥㠯𠙋
仪	儀𠌾𥪺𥫃
优	優𢖒𬿲𭒩
伤	傷慯𠇢𪜯
佑	佦右𨒐𰧼
併	倂傡𠊧倂
使	𠉕𡥐𫹒𰌩
依	㐆𢲙𧛀𭟿
侦	偵遉𠏄𩇜
侵	㑴𠬶𢔀𮃆
俇	𠉫𢓯𢔷𢔺
俞	兪𠈛𠉽𰂙
俪	儷㒧𠌯𠏊
俯	俛頫𨵃𩒙
俱	倶具𥟭𰁬
俾	卑㑭𠈷𢔌
倔	𠢤𥪊𩋎𩍞
候	𠉀𠊱𠋫𫶬
值	値𠉊𫣜𰁲
倾	傾𨻺𩑭𬿦
偫	㣥𠊷𠍰𰂛
偶	禺耦𧪓𬴣
傍	旁䧛𠉱𠊓
備	备𠏆𪝌備
傱	𢔩𢕩𫢴𰁧
僄	𠎼𠐆𠑎𤡑
僚	寮僚𠏗𠐟
儤	忁𠑔𢖔𢖚
儳	𠋂𠍈𢖞𰂼
兀	㐳兀𠕶⺎
兄	㑆𫢢𬆁𭆸
兔	兎𦰋𪞁兔
兢	𠒔𠓆𠳬𣋢
共	𠔏𦱹𩇿𰰥
内	內㐻𡗠內
冔	𠳲𠵄𦀒𦊯
冕	絻𤲈冕𰭍
冲	沖衝𥁵𰜒
况	況况𡶢况
净	凈浄瀞𤂅
凉	涼鿌凉𠒨
几	僟幾⺇⼏
凫	鳧𠒎𣹋𩾖
凰	䍿䳨𠂸𪅔
切	切𪥂𭃄切
刊	刋栞𣓁𭑈
利	利𠜫𥝢𥝤
别	別彆𠔁𠛰
刬	剗𠟉𠠮𣂧
刹	剎𠛴𠜽𭈗
剂	劑䜞𠜸𪗊
剃	薙鬀鬄𩮜
剆	㔏𣂞𦫍剆
剋	勀勊尅𠧶
剓	𠜣𠡩𠡴𣪤
剖	刯𠝒𠞌𬃙
剺	𠞲𠢐𢍛𢾨
劉	刘劉𠞑𠟁
劣	劣𡭣𢖬𢚃
努	伮𠴂𢫓𭄥
劲	劤勁𠡍𠡕
势	勢埶㔟𪟛
務	务𠝸𭄶𰦐
勛	勋𪪹𫤼𫸤
化	𠏁𠤎𠯒𢡺
匯	汇𠥥𣾀𣿬
匹	疋𨑜𫘇𰺰
区	區鏂𫭟𰁳
医	毉醫𠣗𮠙
卉	芔𠦃卉𰏗
印	𠘄𠨑𭅳𭅴
即	卽皍即卽
厞	陫䨾𨻃𩇪
叡	𠮈𠮏𡓝𧢕
句	句𠯶𤖮𫸧
吓	唬嚇諕𠵢
吺	嚅𠱑𠱒𡂛
吼	吽呴㖃𠸚
呃	呝𠲪𧦠𩚚
呆	懛獃𠫡𤶗
呗	唄㗑𠼕𠼚
呢	𠮨𠼱𠽬𣭙
呧	𠯝𠯞𭇇𭈫
呻	𠲳𢈯𣢘𤶴
命	𠇭𠇮𠋒𫝇
咂	𠯗𠴴𠶴𨠿
咏	永詠𠰿𧦋
咤	吒喥㓃𮤹
咨	嗞訾𧫎𪡌
哂	吲弞𢏓𧧍
哕	啘噦𠾲𣤠
哗	嘩譁䀨𠵅
哭	𠴃𠸅𡘈𡘜
售	𨾜𨿈𨿞𱁆
唱	倡誯𪛋𱍊
唼	𠸻𡁕𭊚𭊺
啐	啛𠯥𠵒𠻜
喊	㘕𠳾𠽦𠿑
喏	㘃𠰒𡁠𧧏
喪	丧𡂧𦦭𦱺
嗑	㗐䶗𧪞𱌻
嘉	𤪘𫅘𬻎𭐒
嘶	澌𦠭𧬊𭊫
噀	潠𠸃𠸇𠹀
噇	喠䭚𠲕𠳹
噞	䲓𡄥𪡋𭳤
噪	喿譟𠴵𠹏
嚭	噽𡄂𧯻𭐚
嚷	𠮵𠺂𠼁𫬄
囋	𠼗𡂐𪢙𰉄
囤	𡆰𥫱𥭒𦯁
囮	㘥𡈙𡈫𡈸
围	囗圍𡆫𪢫
囵	圇㖮𠼩𰿡
圊	𫭏𭍬𭱿𰠟
國	囯国𬪇𭍩
圍	囲围𫭋𬆐
土	圡𡈽𡗓⼟
场	場塲㙊𤳈
坏	壞𡎯𤵱𭶦
坝	垻壩䃻𭐏
坞	塢隖䃖𨻑
坟	墳隫𡏶𡼝
坡	岥𡊚𡶅𬔜
坰	埛𡹫𫡃𰃦
坳	垇㘬㘭𡌝
垡	坺墢㘺𡓊
垫	墊㼭𢬋𫮛
垭	埡𡸭𡹄𡹅
城	𩫨𬴡𭩴城
堙	陻㘻䧣𡋘
堞	𡍕𡐽𡑢𥏭
堡	堢㙅𡋠𪧕
場	场𪣍𪤝𭏍
堵	𡦡𩫭𬴢𭏴
塾	𡔊𨶝𨷙𭏼
增	増曾譄𢴣
壁	廦𨐧𨐬𫴎
壇	坛𡐴𫝠𭐀
壚	垆𠫂𡉴𰊼
声	聲𡔝𮊩𮋻
壽	寿𠄆𡭏𮋛
夕	昔𬒵𭥑⼣
够	勾夠彀𡖜
夥	伙𡖿𭪹𰘋
夯	䂫𠛞𠡊𢫉
失	𠇳𢩥𭁆𰻔
夲	夵𠇏𠦂𠦍
头	頭𥘖𧴨𩓶
奂	奐𢍅𢻁𭑏
奃	𡗨𡗰𡘄𣱋
奈	柰耐奈𥘾
女	女𠨰𡚬⼥
妇	婦媍𡞒𢽰
妒	妬姤𡛮𡝜
姒	㚶𫨧𫨪𫰶
姪	㜼𡥺𫦡𫲞
娈	孌𡢛𡤣𡤨
媌	嫹㑤㚹𪝌
媚	𡠂𡡚𡡾𰋻
嫌	𡡫𢙝𤍻𭒡
嬎	㛯𡢎𡤹𡤺
嬲	𠒰𡣠𢣲𤲶
嬴	㜲𡢔𡣍𫲓
存	侟𠩯𡥂𡥅
孤	觚𦣮𫩼𬁣
孰	𠅩𠅶𩪿𭓔
宄	𠬚𡧄𡧌𡧫
宦	䆠𠈄𠋪𥦐
宫	宮𦞨𫳓𬔉
宵	𣆺𫆙𮦋𰟿
寜	𡨪𡩋𡩬𡬛
寞	漠㱳𡖶𰩙
寱	䆿𡬒𥨘𮄡
寳	宝𡪪𪧬寳
將	将𪺟𬌊将
對	对対𫴰𬥫
小	筱𡮐⺌⼩
尢	𫵎尢⺐⼪
尰	瘇𡰁𤺄𰃏
局	侷𡱈𢩁𬗎
屄	毴𣬼𣭈𫵘
屉	屜朑笹𣙝
屡	屢𡜸𡝼𡲹
屧	屟䕈𡳙𧀢
屩	屫𡳯𪨗𭕷
屯	𠀏𨶿𭕾𭕿
屿	嶼礖㠘𡽬
岙	嶴㠗𣵜𰣗
岭	岺嶺𡽹𡿡
峘	𡴿𡵎𡷆𡷗
崚	𡹃𡺿𡻴𪌨
崭	嶃嶄𡼼𡽻
嵇	嵆𥞇𫶞𭖽
嵍	𡺱𡻒𥓺𬑭
嵚	嵰嶔䃢𡼲
嵲	𡸢𡸣𡺼𡿖
嶙	峋𡼵𡽤𡿑
巀	嶻𡽱𡾃𡾺
巃	巄𡹱𡾩𰎎
巘	巚𡿕𪩘𮥲
巠	坙𡿱𢀖𰡮
巤	𡿲𡿳𢀂𢀅
巨	㠪𠫕𢀑𢀓
布	佈㱛𫷁𬥐
帙	袟袠𢂮𰐀
帜	幟旘𢂴𣄞
師	师𠂤𡶫𱀃
幐	㬺𢄑𦞊𦩫
幕	幙㠳𫯜𬞿
幞	纀襆㡤𦄾
幭	簚𢅓𢅵𢅶
平	𠀒𠀭𤓹𤔁
庋	庪攱𢇮𰅪
序	叙㘧䦽𭙒
庙	庿廟𢉱𤸠
廌	𢊁𤙪𪋁𪋱
廑	厪㢙𠪲𢋓
廓	霩廓𢋽𢌓
廚	脰䏭𫷨𫹙
廞	𠪢𢉄𤺰𫷷
廣	广広𭙛𰙞
廷	庭𢌜𨑲𨑳
异	異𠔱𢄖𢍀
弊	㢢𡚁𧷍𰐉
弭	㥝𢏱𭚽𭤭
弶	摾𢐷𣚦𰐞
彌	弥𦇯𨲼𫹃
彦	彥𢒊𫝸𰩡
後	后𢔏𨒥𰐶
從	从従徔𠙂
徹	勶彻𬴲𬴵
忡	𢘷𢥕𢥞𢦃
忱	愖𢗐𢗑𢘚
忽	曶芴𡯖𢗘
性	𢘡𤇣𧢱𪫬
怯	㤼㥘㹤𰡅
恢	烣𢉸𢊝𨒭
恧	聏𠷼𢟄𦗂
恪	愘愙㤩𫭓
悁	𠉌𢛋𢞈悁
悍	捍猂𫹯𭜬
悔	悔𠧩𢙽悔
悦	恱悅𡆦𢛹
惘	罔惘𢜟𰁥
惨	慘憯𢡖𰑯
惷	𢝣𢡳𢾎𢾜
意	悥𢡃𰐺𰑻
愤	憤𢟠𢡝𢤬
慈	㤵𩉋𪬄慈
慹	𢟯𢡶𢢍𰑔
憐	怜憐𢠴𥼭
憝	憞譈𢥦𢥲
憯	㦧𢡄𢡚憯
憸	㤟𢘁𢘼𪫺
應	应𢋗𢡫𫍑
懠	𢡐𢥎𫺊𭝚
懲	惩懲懲懲
成	𢦩𥢲𧶔成
戢	𢧠𢨐𧥄𭟶
戽	𡰷𢨦𣶉𪯬
扅	㞔㦾𢨴𢨹
扑	撲擈攴𢷏
扼	搤搹㧖𢪜
扽	扥㩐𢩺𰔫
抁	𢯴𢯻𢰉𭷙
抆	㨉𢪖𢪛𢵢
投	𢪩𢫹𣪌𭠘
拂	佛咈払𣭘
拐	枴𦫳𪭦𫭦
拖	扡拕𢫌𰓩
拟	懝掜擬疑
择	擇𢍰𪭲𪮉
拳	搼㩲𡙅𢮙
拽	捙𡲝𢶀𦛈
挑	㨄𢪢𢬹𢯀
挟	抸挾𨋸𫏶
挠	摎撓桡𢪼
挸	𢹕𢺃𫾴𰔻
捃	攈攟𢹲𰔼
捩	挘棙綟𭢿
掌	𠫝𤓯𤕄𫵌
揃	㨵𢵏𢶕𢸄
揆	楑𢲇𢲕𬆬
揚	扬𠭲𫳞𬨭
揫	𢱀𩏢𩏶𩏷
揲	𢮕𢱴𢶅𥰰
揽	擥攬㩜𢱯
搋	𢯯𢲽𫿋𰔁
搴	攓骞㩃𢷘
摆	擺襬𢱎𢸇
摘	𠞶𢴨𢸈𢸑
摫	𢵅𢶄𧜴𰓻
摶	抟㩛𢰁𧽢
撍	揝𪯘𫿬𭢗
撒	𢴻𪮫𭯂𰒼
撙	尊𠟃𢵫𰓢
撤	勶揊𢪃𪮌
撲	扑𪠖𫦖𫼆
撷	擷㩪𨘓𪆋
擆	撯㨋𢷷𣛰
擧	举挙𬍋𭢅
擩	㧫㨎𫼰𭢛
擪	擫𢵤𭚋𰓙
攑	㩮𫽥𫽻𫾜
攒	儹揝攢欑
敚	敓𢼠𭣭𭣳
斀	劅𢻧𣀈𪕂
斄	𠩬𣀗𭤎𰚙
料	䉼料𥸾𰪮
斝	斚䑝𠬂𮗶
斤	觔釿𭤟⽄
既	旣既旣𰕰
旦	狚㫜𥿝𭥐
早	蚤𢑖𣅼𰆀
旮	𡉅𤰙𤰚𪽇
旻	旼𣅐𩔉𬐅
昂	仰昻枊𰖄
昇	升曻陹𣅮
昌	𣅊𣆫𣇀𭥗
易	㑥易𠃓𡱿
昧	沬𣆜𫹻𰮒
昼	晝𣅯𦘘𦘙
晒	曬㬠䵘𦚵
暇	叚𦖲𪰴𭦔
暨	曁臮𠕨𡮧
曃	𣇨𥊵𪒡𪾹
曙	暏龧𥌓𨽉
曝	暴𣋏𣌑𭨃
曦	爔㬢𣌀𣎮
曲	麯𠚖𡆡𨴈
曳	抴拽曵𦥙
曾	曽𬎿𭦌𮏥
朒	䶺𢫭𬲚𰮚
朔	䄴𣍮𦙚𦚿
札	剳劄𤵦𭄕
术	朮術𦬸𧗱
朾	檙𢾊𢿵𣀏
李	䤚李𣒶𰌩
村	邨𡵭𢩭𰻣
杘	柅𣐃𣐉𣒺
杞	㠱𠶵𣏌杞
杻	杻𣐬𤘶𫞈
极	極㭲𣑕𣒝
枵	呺𢪶𣜵𦚊
架	榢𢉤𢱌𣕧
柺	𣐶𣐷𣑍柺
栅	柵𣑭𨴕𮤊
栴	枬㮵𣑪𣒰
样	様樣㨾𪮲
格	挌𠲱𥰋𭡗
案	桉𥞬𭓵𭪠
桓	𣒯𧻚𨕹𬕠
梗	挭𠡣𢯬𣖀
棨	綮𢧊𣕥𣘼
椁	槨𣠐𥕖𬃬
椭	楕橢㯐㰐
椿	杶櫄𣝙𣠍
楘	𣖶𥠪𨍎𨎸
楯	碷𣛝𬼻𭢣
榄	欖㰓㰖𥤝
榉	櫸欅﨔𣟱
榖	𣖫𫪙𬆭𭮹
榮	栄荣𠡋𬊇
槔	槹橰𣓌𣘶
槽	𡐋𣡘𤡐𪴊
樹	树𣕒𣚤𰏩
橛	橜氒𣐍𦪘
檮	𣚑𣝷𤘀𥖲
檾	𣘑𤍔𥣻𰘓
櫏	杄𣘝𭬜𰗬
櫜	韟𡒩𣠀𩏤
欠	㐸𣣓𰶷⽋
歙	噏㒆𨝫𪴱
歪	竵𥫀𥫇𰀚
殙	㱪𣧟𣨯𩔉
殳	杸𠘧𢎦⽎
殴	敺毆𠥝𣪅
段	𠩻𠪅𫨻𭣨
殷	慇𣪞𫳪𰻷
毂	轂𣫂𨍔𰚅
毓	艈𣼿𭯉𮌫
比	夶㱛𣬅⽐
毫	乚豪𡨉𢑸
毳	𣯝𣯠𣰗𰚳
毵	毿𣮟𣯶𣯺
氈	毡𣮿𩯤𭯨
氏	𠂩𧦄𫞕⽒
民	𠘽𡻾𫞖⺠
氲	氳𭯳𰚼𰛃
汉	漢𣶔𣾒𤁉
汹	洶𣶑𣺷𭰔
沍	𠖱𣲐𣲑𣲨
沙	砂𡋷𣲓𣲡
沟	溝㳰𣹀𭱋
沱	沲𣴾𣵺𣵻
河	𢀎𤿁𤿄𬈊
沴	沵𣳅𤄽𬈄
沸	𣲴𩰾𩱎𩱣
沿	㕣㳂𡵴沿
泛	氾汎𣳋𮎊
泪	淚㴃𠖻𣷔
涌	湧𣵋𣵳𣹄
涓	蠲㳙𠗓𧨜
涵	浛𣷉𣹢𥓞
涿	𣄻𣵠𣺵𣽗
淋	痳淋𣾜𩱬
淹	淊渰𣼜淹
渚	濐陼㵭渚
渤	㴾𭱢𰜎𰜙
温	昷溫𰜕𰜖
湄	𣽪𣾨𤃰𤃱
湮	堙歅𣽔湮
溃	殨潰𤀭𤃘
溉	摡漑𣲪𰝧
準	准凖𪟻𰜛
滑	顝滑𬟟𰌏
滔	㴞𣵁𣵥𪶴
滗	潷㲺𣴡𣺱
滞	墆洔滯𤨮
滥	濫㜮㳕𣽦
滭	㳼𤅳𭱡𰛡
滹	泘𣼻𣿋𤀶
漂	𠷻𣻔𣿖𤄚
演	𣿶𤀋𰛑𰝈
漙	𣶣𩃘𩅂𬇘
漢	汉㵄漢漢
漻	㵳𣼢𣽓𤁸
漽	𣖅𣖸𣸒𣹲
潘	䆺𣺇𤄜𭻫
潨	潀潈灇𣽇
濘	泞𣽹𤀑𬈿
濛	溕蒙靀𪷟
濫	滥濫𬈋𮇊
瀰	㳽𣴱𣶿𤅤
瀵	𤀬𤄤𤄪𬉂
灂	𤅥𤅨𤅪𤅯
灊	𤄵𤅬𨽨灊
灌	樌潅𤂦𫞞
炉	爐罏鑪𨈝
炕	匟𤇛𤊚𤌁
炫	昡眩衒䝮
炭	𡎅𡵼炭𰞚
炼	煉鍊𣿊𧹯
烏	乌𠂶𤚶𬻆
烓	𤌒𤌳𧟼𬴸
烘	灴𧇲𧇺𰃍
烛	曯燭爥𤐋
烝	㷥𠄪𤇶𬖧
烧	燒㶮𤌸𧄣
焕	烉煥㬇𤎈
煉	炼煉𥒯𧹩
煜	焴𡟄𣈫𬊸
煦	休昫𤆨𤋗
熹	暿𤋔𤎿𤏴
燬	㷐𤈦𤌋𤐘
爿	丬𤕪⺦⽙
牝	𤘕𤘥𪊯𭷓
牡	𡉯𤚴𩡶𪋂
牦	氂犛髦𤙚
牧	𢪛𤘴𭷁𰠩
特	犆𤙰𤛀𭷅
犐	㸯㸰㸱𢱃
犓	𤚂𤚄𤛃𬌝
犬	犭犮⺨⽝
犯	犯𢒿𤜛𤝑
狀	状狀𰠓𰠮
狗	豿㺃𢑪𧲿
狧	㹺𤝰𤠟𮍵
狮	獅𤜳𤞏𭸨
狱	獄𡈭𤡈𰡤
狷	獧𢔮𭸏𰡨
獌	䝡䝢𤡁𤢞
獠	䝤𤜶𤢙𤢸
獭	獺㺚𧴡獺
獮	𥙮𥜦𥜬𬤾
玊	珟璛㓘𤥔
琐	琑瑣璅𤨏
琫	琣鞛䩬𩊌
瑁	㺺𤣽𭻝𰡹
瑮	𤩗𤩰𤪒𰢕
瑶	瑤𤧏𤪅𰢊
璃	琍瓈𤫚𭺇
璊	玧㻊𤨸𫞩
璩	璖𤦲𤨎𤩁
璹	𤩇𤩈𤩉𰡽
璺	㼂𤪭𨮆𨯜
瓊	琼𤩞𤪞瓊
甑	鬵䰝𣍎𩱭
甒	𤭎𤮢𬐳𰢢
甙	𢎌𤮼𨟲𨠍
男	侽㽖𤰛𰢽
畀	畁𢌿𢮅𢮧
畅	敞暢鬯𮣻
畝	亩𢽒𰕽𰣅
異	异異𬏋異
當	当𤱭𫷄𬔢
疋	𤴔𤴖⺪⽦
疒	𤕫𤴫𤴳⽧
疠	癘㾐𣨸𤼚
疢	𤵜𤵲𤶝𤻞
疣	肬𤷊𦚥𪐤
疬	癧㿛𤻤𭼰
病	𤖉𤵣𪗅𰣺
痞	癖脴𤶂𪪓
痪	瘓𤹹𤹿𤻨
痴	癡𠈴𢣕𤶢
瘐	𤵨𤵵𤶉瘐
瘳	𤵃𤹭𤺟𬏬
癣	癬㾌㿅𰤊
癸	𤼩𫻮𰤌𰪑
癹	𤼧𤼯𦳠𨂩
皑	凒溰皚𩄟
皞	曍皡皥𤾚
皪	㿨𤽥𤾾𰤕
皴	𦫝𭐩𭐪𭽫
皵	𣛵𤿸𥀟𦫓
益	㬲㴁益益
盌	𠙀𪾎𫩨𭮓
盍	曷盇𥁋𥂊
盝	𣿍𥂖𥵁𦾞
監	监𪾋𭾆𭾋
盪	𡑑𣻭𥂳𰝝
盬	𥃉𪉶𫎡𭾌
盱	𥃳𥅚𫎏𰕱
盲	盳𤷐𥇋𰥲
盾	楯𠩮𥍿𭾜
盿	䁕𥄐𪾠𫡴
眄	䀎𥃥𥄝𮙴
眓	𣆈𥅩𧵝𧶂
瞂	㕹𠪫𢧕𩊊
瞇	𥅘𥇆𥇎𦟂
瞤	𢡞𥆧𥋃𥌎
瞥	覕𥋗𧢍𰥼
矮	躷㾨𨱥𩫇
矾	礬𥐥𥐲𥖎
砀	崵碭𡼍𡾕
砺	礪𠪄𠪿𨯅
砻	礱礲鑨𤮨
硗	墝墽磽䂪
碧	𤫅𦃧𮀱𰋨
磐	䃲𣍵𥑍𦛵
磥	㠥𥒮𥗼𨄱
祊	閍𥚧𥛱𥛻
祓	鿆𥘬𬒲𬓒
祢	禰袮𥙄𮂢
祥	羊祥𥙶𰧵
祭	摖𥘾𥙊𫞴
祺	禥𥘕𥚼𰧮
禄	祿祿𥜅𬓈
禍	祸禍𮂁𰧲
禴	㒢𥚗𥜫𧆆
禹	㙖𢁰𥜼𰁻
科	𥝹𮂶𰪧𰭰
稃	粰䄮𥞂𥹃
稊	蕛䄺䅠𥝼
稌	蒣䅷𥺌𦺪
稕	𥟆𥢟𥤁𦽑
穇	䅟𥠩𥤇𧂅
穈	𢋟𢌑𥡹𮮈
穳	𥝺𥣚𥣪𥣶
穿	䆤䆥𥥢𥥯
窌	𥥤𥥹𩂞𰩇
窐	瓾𤬿𤮰𩰳
窕	𥧽𥨑𰩋𱁕
窱	窱𡡃𡩢𰩏
竄	窜𤢱𥨥𥨬
竊	窃𢿝𥨵𫁝
竑	竤䇊𤣦𨌆
笼	籠𦌼𪚖𮆲
筍	箰𥭩𥳦𬕇
筐	匡筺𥮟𫧖
筛	篩簁簛籭
简	簡䉍𥳑𫈉
箍	笟篐𫁹𬕣
箦	簀蔶𤖓𥴹
箫	箾簫𪛕𪛖
箭	𥮙𥰸𥲫𥳭
篠	筿𥭪𥭸𥴽
篡	簒𢸥𥱕𮐋
篷	竼𥭗𥴣𨎳
篽	蘌䢩𠏣𩵎
簟	磹𥲺𥷦𫂍
籔	䈹䉤𥯴𥰞
籝	𥯰𥷶𥸏𮆝
粝	糲䊪𥻃𥻑
粥	𢐫𥺞𥼫𩱟
粳	秔稉粇𥠛
粼	磷𤏞𥻘𦧿
粽	糉糭𥼐𫃄
糗	䊆𥽃𥽙𩝠
糵	糱𮇽𮒷𮓒
糾	纠㺶𥾆𰏱
紧	緊𦁫𦂳𦃂
絇	䋧𡳍𭕣𰬆
絣	𢆸𦴏絣𰬔
絥	𩊙𩎓𩎧𫄢
絻	㡈𦂔𧚇𰬜
綥	帺𥾦𥾻𦁰
緇	缁𬘑𬰫𮖓
緎	𦎘𩋉𪑝𰬟
練	练練練練
縒	𦄙𦆧𦇈𬘷
縢	𣎝𦅌𦪝𰫭
縬	𦂎𦄉𦇰𦈚
繇	蘨䌊䌛𦅸
繫	系縘繋𣫦
繻	緰𦅎𦅏𦈡
纁	䌲䙧𦇟𫄸
纖	繊纎纤𭀁
纘	纉缵𫡋𫡳
纰	秕紕𦀘𧧺
纼	紖絼䊶𦄘
纾	抒紓䋒䋡
绁	紲絏緤𥾰
绅	紳𣃵𦁴𩉼
结	紒結𢢂𥾫
绚	絢𡱺𥾡𦃜
络	絡𦃅𦃆𭘞
绠	綆䋁䌄𥿒
绥	娞綏𣮄𫃭
绿	綠緑𢅞𫃱
缋	繢𦆠𦇞𦇣
缎	段緞𦂰𫟁
缓	緩𦅻𦇌𦇻
缦	縵𦄡𦆅𰐷
缾	缾𪾘𬙌𬸲
罄	磬𥥻𰌿𰥃
罺	𥷮𦌆𮊗罺
罾	𦌘𦌛𦌝𭧀
羊	𦍌⺶⺷⽺
羯	𦍨𦍾𦎂𦎒
羶	𠆞𦎞𦎵𦏂
耘	秐𦓷𦔐𦶮
耸	聳𡷽𢕈𮋹
聄	𦕇𦕑𦕗𨸧
聯	联聯𫠩𫯺
肅	肃䏋𬕝𬣉
肋	肋𦟯𬜑𰮂
股	脵𦙶𦚂𰮏
肥	䨽𦘺𰑈𰮆
肩	𢩌𦙪𦚑𫵔
肺	胇胏𦚃𰮈
胃	𦛂𦝩𦞅𭥫
胗	𣍨𤷌𦙳𦜌
胥	偦縃𣆁𦙃
胮	膖𤵸𦡊𮌨
能	䏻𦝕𫧇𮌛
脘	𦛤𦛮𦜐𰣸
脧	䘒𡉍𡱥𧗔
腦	脑脳𤦏𦗮
膂	旅膐𦛗𭄸
膘	脿膔臕𦣁
臜	臢𦠛𦢤𩵆
舆	輿轝𨊮𨏮
興	兴𦥷𨑁𫵪
舍	捨舎𦧶𬾕
舑	㐁䑙𦧏𰰀
舒	忬䣄𨥤𬜓
般	𣪂𦨗𬿆𮎆
舲	𦪩𦫃𦫄𦫊
舵	杝柁柂䑨
艖	䑡𦪮𦪸𦫅
艘	㮴䑹𣔱𦪁
艱	艰𡆐𪤱𰌌
艽	芁𦸹𫈇𬜫
芈	羋𦍋𪦳⺸
芥	介𠟝𣓴𦬉
芸	蒷蕓𥘟𦱚
芼	㧌𥟪𦯮𦳁
苍	蒼𦭆𦾝𫇳
英	偀𦮥𮎦𮎧
苶	㭉𥬞𦬼𦮕
苾	䭱𥞻𪏺𪐆
茢	䓟𠞝𦱝𦴟
茶	茶𣗪𣘻𦮭
茿	𦯋𦵶𧏤𫇼
荓	䓑𦰝𬝀荓
荞	荍蕎𦰎𪍷
荨	蕁䕭𦼓𧁘
荩	藎𦳒𧂰𧃤
荫	廕蔭䕃𦺼
药	薬藥𤂼𤒝
荻	蔐藡𦰂𧁱
莊	庄𤖊𫻾𬌊
莛	筳𨓍𫸓𮐄
莽	莾𢳠𦷶莽
菆	𦮆𦰨𦺵𦻡
菜	𦬁𦰔𬴹菜
菢	抱㲒𢯿𣭀
華	华華𠌶𦾓
菽	尗𦬱𦭊𦯂
葆	藵𣼑𦬽𦽻
葵	𦮙𦷡𬝢𬞂
蒡	𦱘𦾭𫟐𬝧
蔡	𣞖𦬨𫑠𰙆
蔬	疏䔫𬞞𮒄
蕕	莸𦵵𦽈𦿥
蕴	菀蕰藴酝
薦	荐𠭶𧲛𫸠
薰	薫蘍𦹝𬟓
虉	𧁢𧄷𧅖𬟁
虍	𧇁𬻉𮓗⾌
虒	𠩳𫳔𰲚𰲝
號	号𤀃𭈹𰲛
虧	亏𧇾𧟯虧
蚀	蝕𧐂𧵳𮔣
蚓	螾𧈳𧍢𧓒
蚔	𧉜𧎪𧓑𧵄
蚩	𧈨𧉌𫊵蚩
蚪	𧌟𧏆𧐝𧐵
蛆	䏣𦚭𧏏𧐅
蛎	蠇蠣䘈𧖄
蛘	蝆䖹𧋪𧒃
蜚	𧍃𧓊𧕒𧕿
蜾	𧒘𧓞𧓠𧔽
蝑	𧌊𧌋𧌖𧎎
蝦	虾蛯螧鰕
螂	蜋𧎟𧖒𧖗
螜	𧎅𧏚𧐜𧐡
螷	蠯𢋜𤼜𭚏
蟹	蠏䲒𤐃𩼠
蠕	蝡𧏦𧑮𧔇
蠚	𧊝𧊬𧍗𧍷
衢	𢖦𧘀𧘆𫋱
补	補䋠𢒏𢼹
衧	𧘎𧘘𧘚𧙶
衳	䘴䙂𧛤𧜢
衾	𧘭𧙐𧙳𬡌
袖	褎褏𠍡𧚘
袡	衻袇𥾢𥿛
袴	𥚓𫋾𮁣𮁯
裘	𣰐𦽲𧚍𭯧
裥	襇襉𧟉𫌙
裨	朇禆𥚈𧚽
裹	褁䙨𦆪𮖐
褫	裭𧚜𧜑𰉳
襐	𧝌𧞌𧞦𮂚
襡	襩䙱𧟅𧟎
襮	𦃙𦆿𧟊𮂡
覆	覄䨱覆𧠃
覈	𩅓𩅢𮗄𮗊
覹	矀𧢒𧢓𫌭
覼	𧡓𫌨𮗛𰴒
觐	覲𧢚𩌶𩌸
觓	觩𤙠𧢳𧤝
觚	䉉𧣋𧣗𨠋
觞	觴𣝻𤔰𨢩
觢	㸷𤙲𧣯𧤊
觥	侊觵𧣥𨠵
觯	觗觶𦨟𧣄
觱	𥷑𧤅𧥀𧥑
觴	觞𧥉𫌰𬋺
訮	詽𧥪𧦐𧦼
訰	𧥫𧦏𧦖𰵍
詍	㖂䛖𧥨𰵔
詟	讋𧮩𩐶𪚥
誇	𧥢𧧭𧧳𧩊
誉	譽𣁎𧭒𰴧
説	說说說說
諆	鿁𧫠𬢝𰵲
謁	谒謁謁𰁽
謏	𧨠𧩮𫍲𰵅
譶	𧭛𧮦𨑂𫴪
護	护䕶𧦈𫉚
譸	嚋诪𧪀𬢪
讎	仇雠𩀕𬯴
让	譲讓𦦬𧮨
训	訓𡿼𧥥𧥿
讷	呐訥㕯𧨣
讹	吪訛譌䚰
诃	苛訶㱒𧪆
诌	謅㗙𠴾𧩖
详	詳𢒑𧨢𮊤
诸	諸𢒕𣦁𧭷
谆	諄𣮢𧭫𧭺
谊	竩誼𧧼𧨏
谥	諡謚𧫺𮄷
谦	謙𧫨𮘹𰵋
谽	𥓂𧮰𧮳𰧂
豉	䜵䜻𢻃𩚡
豐	丰豊𣍈𧯮
豗	拻㒮䝇𧱉
豨	狶𧳐𫹇𬚮
豲	獂䝠𧱂𧱖
貊	貃貈貉𬂎
貙	䝙𤠾𧲰𬥍
賸	𦫂𧷽𫧄𬂉
贊	賛赞𫌡𫌦
贝	蛽貝𪚾⻉
负	偩負𢰺𧴥
责	責㥽𧵩𧶌
贫	貧𡧋𥥄𰼡
贶	况貺𧵦𧵮
贻	貽䞅𧵫𰷅
赪	緽赬頳䞓
赳	𠡟𧺇𧺈𧺯
趁	趂𢌝𧽃𮚶
趆	𧺦𧺳𧺽𧻎
跄	蹌蹡𦭠𦭫
跚	𨀢𨅖𬨡𰸗
跛	㝿𤿑𨈵𰸅
距	歫钜𧣒𭉍
踌	躊𥲅𥴳𨅡
踰	𡫞𨄫𭼄𮄶
踼	𨃠𨄆𨆉𰸄
蹈	𨂆𨂻𰸁𰸒
蹊	𡏛𤲺𫏖𮛪
蹤	踨𧿛𨄦𮛙
躂	跶𨂛𨂧𨂨
躏	疄蹸躙躪
躲	趓躱𣕼𩒜
軎	𠦟𡸸𨊢𰹲
軝	䡋䩓𩉬𬨂
軧	𨋆𨋇𨌮𰺀
軿	輧𨍍𫏹𫐌
輶	輏𡷚𡸋𬨎
轉	転转𫩄𫸜
轒	𨋂𨎨𨎾𮝷
轹	轢𨍮𨏬𮝩
较	較䡈𢨏𨊿
辊	輥𨍲𨍽𨎊
输	輸𪟺輸𰹰
辘	轆𨌠𨏔𩌫
辚	轔𨍼𨏏𰹮
辨	辧釆𭮧𰆴
辭	𨐒𬋹𬢹𰫨
辱	𢛚𢟲𢟹𭔱
農	农𡪊𦱯𨑇
辶	辶⻌⻍⻎
辽	遼𨖒𨖚𭲜
迂	込迃𨑛𪪬
过	過𨒵𨓺𬨨
进	進𡥦𨗃𨙟
远	逺遠𢕱𨖸
迥	逈㢠䢛𮚹
适	冟適𠐝𡣪
逊	巽愻遜𨔇
逭	䠉𨙕𩁧𫐸
遄	𨒎𨖇𨖺𬩗
遇	𠓱𨔆𨔒𫑈
適	适𨒙𨗁𰙷
遰	𨗼𨘛𨘬𰻆
遲	迟遅遲𫵙
遴	䢯𨖉𨗄𮟠
邕	𡿷𢀍𪩡𪪝
邱	𠀜𨚑𨚬𨛆
鄂	䣞𨜝𨞍𨟨
酬	詶酧醻𨠩
酳	𨡀𨡚𨢂𨢖
酵	𨡃𨡆𨢀𨣑
酷	焅𨌒𬪵𮠭
醉	酔酻𨠪𮡊
醙	䤇醙𨡻𨤇
醮	𥛲𨣐𫑿𬋕
醰	䐺𨣌𨤌𪍵
醵	䣰𦟳𮩎𰗌
醽	𨠎𨣖𨤀𨤍
醾	醿釄𨣽𨣿
釁	舋衅𥃘𦦟
釂	𣤚𣤹𨤊𰼕
采	埰寀採𰗕
释	釋𥼶𨤟𬬊
釚	釻䤛𨥐𫟲
鈚	錍鎞𪾘𬬫
鋘	𦥉𨦚𬭌鋘
錍	鎞𨤽𰼺𰾎
鍑	鍢𨫙𮢩𰾟
鍭	翭𨩀𬫺𬭤
鏊	𨪠𨫺𨫼𨮽
鏓	鍯𨨟𨬃𰾱
鐕	鐟𨯩鐕𰾷
鐵	鉄铁𨰕𮢨
鑙	𨪴𨮺𨯀𬭿
鑿	丵凿𨬭𬬜
针	箴針鍼䥠
钏	玔釧𪩢𫶨
钩	鈎鉤𠛎𨪋
钻	碹鉆鑽𨉖
钿	鈿䥖𨰎𮓿
铏	鉶䤯𨦕𨧂
铫	銚𢊙𤭈𨰑
锄	助耡鉏鋤
锊	寽鋝鋢䤣
锔	鋦𨦴𨧙𨨠
锛	錛鐼𨪻𰧆
锨	杴鍁𣔙𣞘
锻	煅鍛𨩷𨪇
锼	鎪䤹𨦢𨫂
镊	銸鑈鑷𥬬
镰	劆鎌鐮䥥
镶	瓖鑲𮣐𰽙
閒	𨳢𨴅𫔮𬮈
閛	䦕𨳩𨳵𰿬
閜	閕𪾌𬐣𬮠
閭	闾閭𬮐𬮗
闉	𨶴𨶵𨶾𬮱
闌	阑𪧶𫴨𬮔
闢	𨳥𨴔𨵓𰿾
门	門閅𰃦⻔
闸	牐閘𤗠𤗮
阃	梱閫𠢷𣏔
阉	剦奄閹𨴄
阐	閳闡𨴁𨴝
阖	閤闔𨵯𨶩
阵	塦陣𣃵𣃻
陋	陋𨹟𫠥𮥇
陨	殒磒隕𠉌
隅	堣嵎𨺁𨺷
隑	𡎼𨻭𨻯𬮿
隸	隶𥻳𦀱𮥵
雲	云𦤆𩂔𮦊
霁	霽䨖𩃟𩄄
震	誫𩆉𩇒𫕫
霢	霡䨫𩄂𮦠
霭	靄䨠𩅳𫕴
霮	䨢𩄕𩅷𩅾
靆	叇霴𩃠𩃷
靇	𩄀𩄱𩆇𩆈
静	靖靜㣏𰁓
靤	𦫥𨣙𪐼𭣘
鞍	鞌𥿽𨋴𩣑
鞧	緧䋺䱸𦂏
鞫	諊𡫭𥷚𮆾
鞬	𦂩𩎀𩎅𮧨
韋	韦𣍄𫖌⾱
韐	𢂷𢄍𩎱𱂆
韢	𩎰𩏚𩏲𬰶
韨	袚韍黻𩎛
響	响響響𬳧
顩	𩑳𩕿𩖆𱂫
页	頁䈎𩑋⻚
顷	頃𩒵𩓏𩔥
顺	順㥧𠈼𩑎
颒	頮𩒌𩔁𮨡
風	凨风𨒷⾵
颲	𩗦𩘃𩘛𱃘
飀	飅飗𩗠𱃊
飒	颯䬃𩗁𫗆
飛	飞𩙱𮨶⾶
飴	饴𨭄𬲖𬲟
餀	饚𦤦𩡔𮩜
養	养羪𩛬𫝥
餔	䊇𥂈𥹴𫗦
餪	𩞪𫗔𫗬𬲗
饨	飩𥸵𩚊𪌋
饬	敕飭𩛙𮅲
馅	餡䭑𤑃𨢝
馊	餿𩜯𩝯𮩏
馋	嚵饞𩝎𩟖
馬	马𩡮𫠉⾺
馲	𤜤𩢐𩢵𱄽
駉	駫䮐𫘍𬳶
騣	𩦲𮪣𱄦𱄰
騮	骝𩥖𩥺𱄭
驄	騘骢𩣢𩨂
驅	駆驱𩣌𱄙
驢	馿驴𩢬𩧥
驮	馱駄䭾𨈷
驺	騶𩣿𩤍𱄜
骂	罵駡𦋻𩡿
骅	驊𧄪𩤉𩦰
骎	兓駸𩤨𩤿
骛	騖𩤝𩥎𩥦
骠	驃𩦈𩦾𩧙
骤	駎驟𩧁𰇂
髒	脏𩦦𩪎𩪝
高	髙𠆪𬞩⾼
髬	𨲐𩬧𩬴𰚏
鬊	巛𩭱𩮦𩯐
鬝	鬜䫘𩭠𱆀
鬤	𣰶𨳃𨳆𩰉
魄	𣍸𥙃𩲸𰁮
魈	㺑𤞚𤢖𧳍
魗	𣀓𣤫𩳺𱆛
鰐	鳄𩻙𬵸𮬋
鰡	䱖𩸛𩺜𱈊
鰧	䲢𩶓𩹙𩺭
鲈	魲鱸𩽬𮬗
鲋	鮒𩷺𩸅𬵣
鲦	鯈鰷䱔𩵌
鲩	鯇鯶鰀𩸩
鲫	鯽鰿𩺀𩼚
鲳	鯧䱽𩺏𩼺
鲽	鰈𩸏𩻵𫙢
鳆	鰒𩼵𮬆𮬑
鳗	鰻𩺴𩻠𫙿
鳝	鱓鱔䱇䱉
鳼	𣁑𣁓𪉃𮥷
鴆	鸩𫚲𬷚𮬮
鴇	鸨𬷂𮬬𮬰
鴔	𩾳𪀐𪃃𫛡
鵀	𨿂𨿃𪀼𬸊
鵌	鷋䳜𪄫𱉸
鵹	𨿯𩁄𩁟𱊃
鶂	鶃𪁌𬷼𱊈
鶯	莺鴬𦾉𪄙
鷚	雡鹨𫜆𱈹
鷹	鹰𢋥𩦵𫠕
鷽	雤鴬鸴𪈔
鸒	𩁕𪇬𱉰𱊭
鸠	勼鳩䧱䲥
鸤	鳲䲩𨾈𨾋
鸪	鴣䧸𩿵𪆘
鹉	鵡䳇𨾥𫛁
鹎	鵯𨿵𪂃𪄆
鹏	鵬𩿾𪂙𪈵
鹐	鵮㪠𢽣𪅎
鹙	鶖𪀖𪃩𫚴
鹚	鶿鷀䲿𪇔
鹫	鷲𩀻𩾵𪆩
鹶	𪉝𪉢𱊶𱊸
鹹	醎𨤄𪉳𬐴
鹺	鹾𨣩𪉤𪉵
麕	𢋵𪊦𪊽𮃶
麧	𥝖𥸽𪌇𱋇
麾	𣬡𪎜𪎮𫿒
黂	𪎬𪎯𪎰𱋱
黔	軡𦌣𪐸𪑙
黤	𩅝𩈷𩈿𪒻
黽	黾㫣𪓕⿌
鼁	𪓡𪚸𱋻𱋿
鼈	𣀴𮦮𰳝𱌇
鼘	鼝𪔥𪔱𱌌
鼛	𡅦𪔌𪔘𮮧
鼪	狌䲼𪕕𪕣
鼬	𪕏𫠘𫧊𬗧
鼯	𧋋𪁙𪕜𪕡
鼶	𪕧𪕬𪕻𪕽
齆	𪖱𪖵𪖿𪗃
齍	璾𪗐𬐢𱌘
齎	𪗎𬹳𮚁𰷎
齝	𪗪𪗺𪙋𱌯
齩	𪗡𪗰𫜪𱌛
齰	齚䶡𪙮𫜬
龃	齟䶥𪙵𭭞
龉	齬𩩑𭭢𰭮
龌	齷䠎𮛿𮯎
龛	龕𪚕𮯚𱍀
龠	籥𠋁𠎤⿕
𠐻	𠎾𠏯𨼭𰂹
𠠝	𠝄𠟄𠠏𫥳
𠥒	𠚜𠚞𠚡𠥪
𠨭	𠩀𠩉𡴈𩰋
𡂒	䜠𡀹𫪪𬽟
𡄷	𠱣𠽭𠽮𠽯
𡛝	㛑𡛒𡛹𡦞
𡰿	𡕞𡕠𡕡𡖆
𡱣	𡱱𡲁𡳌𰍶
𢍏	𠔉𢍊𢍒𨤑
𢎄	戨㢦𢎅𢦪
𢑢	䝆𢑼𣊸𧰮
𢘽	𢂝𢖪𢖯𢚕
𢹍	㩬𢶐𢸤𬋵
𣂁	𣁶𣁿𣂀𣂇
𣚺	𣫿𤳡𦔣𦗱
𣭲	氄㲝𣯍𣰇
𣯜	㲙㲣𣮬𣮸
𤒦	𤒡𤒥𬋃𭟠
𤜹	𣢒𣢧𤝀𤝆
𤡳	𤟸𤡄𤡋𤡻
𤬔	𤫺𤫾𤬇𤬍
𤳯	𤳌𤳐𤳼𥷿
𤼺	𠮆𤼰𤼹𧶢
𥉈	𠊹𥈌𥉉𥊕
𥑋	䂯䃶𥑰𥒒
𥥧	𥦥𥨔𥨮𥩊
𥨒	𥧞𥨢𥨺𥩂
𥴫	㩔𥳨𥷝𥷽
𦎣	䍰𢐽𦏉𦏍
𦐉	䟳𦏿𦐼𦑡
𦓝	𦓙𦓚𦓛𦓚
𦔥	𦓻𦔜𦔫𰭲
𦙫	𤏾𦡅𨡶𩜎
𦜋	𦜗𦜾𨡐𨡘
𦨲	舤𣔶𦨌𬂦
𧇼	㙱𡎪𧰑𰊽
𧉞	𧑗𧑶𧒠𮔾
𧎰	𧒝𧔡𧖉𧖏
𧙉	𧙬𧙵𧛿𧝏
𧲝	𢆈𢖨𧲔𧲞
𧳅	𣬐𣬒𧲬𧳡
𨋖	𨌡𨍸𰹏𰹦
𨍌	𨌲𨏝𨏵𨐂
𨝸	𨟜𨟣𨟩𨟬
𨡮	𨢨𨣭𨣻𨣼
𨭖	㔊𨬧𨮮𫔑
𨷭	𨴻𨷅𨷠𮤗
𩑣	𤴨𩑌𩑲𬱔
𩑦	𩓔𬱈𬱕𮨄
𩚚	䶿𩚬𩜄𬲩
𩛢	𩜔𩝧𩝶𬲓
𩣇	𩢯𩣈𩣐𩥒
𩥲	𩥹𩦙𩧗𬴇
𩧆	𩦏𩨐𱄯𱄻
𪀚	䲲𪀵𪁿𱉣
𪃈	𪃇𪃤𪄾𪅸
𪊉	䴜𪊃𪊊𱊽
𪏂	𪏁𪏃𪏋𪏦
𪒡	𪑠𪑫𪑼𪒛
𪓬	𪓢𪓦𪓯𱌅
𪗋	𧚵𧛁𧜍𱌙
㔍	䈟𠟬𠠀𣃇𣃍
㕧	䐖𣢁𣢂𣢍𣢎
㞁	𡯣𡯧𡯫𡰃㞁
㞇	𡯹𡰂𤺸𤻅𭕑
㠵	𢁹𢂙𢂠𢂪𣥈
㡛	㡃㡆𢁣𢂩𢂾
㣅	𢏵𢐛𢑊𣩳𭛆
㦰	𢦜𢦝𢦺𭟲𮧇
㩋	㪩𢱩𢸳𢹱𪮋
㩧	𢹯𢻭𣀛𣀠𣞺
㪺	𣂏𣂐𨞜𨟉𨟛
㻨	𤦁𤦟𤦼𤧩𤧬
䂎	𣡿𥎑𥎝𥎥𭣓
䎈	𦏸𦐕𦐞𦐪𦐫
䐑	𠝝𦜈𦜪𦜫𰯏
䐪	𦞾𦠬𦢥𦢿𰯠
䘓	𧖾𧗀𧗐𧗛𧗜
䡰	䡠𨋔𨍵𨎁𰺘
䤨	釽𨥝𨥭𨦝𰽸
䬍	𩖨𩗛𩘐𩙤𬲀
䬳	粄䉽𥹎䬳𱃷
䭔	䊚𩛍𩜀𪌤𫗰
䭘	鐛䬬䭊䭗𬳑
䯽	𢒷𩔻𩭍𩭖𩭸
䰏	𩬄𩯰𩯶𩯷𩰁
䰖	𨲽𨳄𩯒𩯳𱆈
䰡	𣧞𩲥𩲫𩳁𩳂
䱎	䱍䱭䱴𮫵𱇥
䶉	𤠑𧳽𪕋𪕚𪕢
一	壹𠤪𫜢𭟮⼀
上	丄𠄞𫵂𬅸𰀎
丰	豐𡴀𡴇𡵄𫵮
临	瀶臨𦣲𦣷𫑻
乐	楽樂㦡𨊊𪟣
乖	𠁬𠁰𠂯𦭅𦮃
乙	乚𠃊⺂⺄⼄
京	亰𡬱𢂋𢈴𦣿
仁	忈忎𡰥𰐼𰑢
仄	庂𠨮𠨻𠩩𤴩
伏	宓㐲𤠪𥦸𥧜
众	眾衆𡿻𥅫𫡑
似	佀価㐶𠋨𠚦
佻	恌挑誂𨋫𰂆
侐	伵䦗𠇻𠗅𨴎
俟	竢䇃𢓪𥅏𥏳
倏	倐儵𠊅𢿅𤟏
傀	𠎺𠐤𠐦𧝛𫣅
傑	杰𠎀𪝨𬿼𭪪
傲	奡嫯慠㜜𭒀
僕	仆𡡐𧀸𫸆𬽵
儒	㐵𠍶𣽈𪝥𰁡
允	𠘮𡴞𡹿𡻏𭀗
免	矏免𭀠免𰌞
全	㒰全𠌆𠓳𠓴
兩	両两匁兩𭁢
兴	嬹興㒷𠎢𢍯
兵	𠈯𠉔𠡿𠦛𠬿
其	亓𠔐𢍌𬢝𰁖
具	𥃲𬥟具𰋙𰥍
兹	茊茲𠧦𦱳𭵝
冀	丠兾㰟䔬冀
册	冊笧𠕋𠕐𠕋
再	𠕂𠕅𭁡𭶪再
冏	囧臦臩𡆾𡇇
冓	𣫳𬼾𭁪𭁫𭁯
写	冩寫㝍𭂁𰩛
冰	仌仒冫氷𣲝
刈	苅𠚫𠛄𠛟𭃆
刉	刏𣱕𣱚𣱞𦏑
刑	㓝𠀦𠛜𠛬𠜚
列	烈列𠛱𠜊𠜺
刘	劉𠭱𡭀𭄒𭄘
删	刪𠛹𠜂𡬬𨚿
刮	劀颳𠜜𠟽𫇔
刳	㓬𠛒𨴇𪟉𰄨
剔	掦𠜓𠠡𢱦𰄝
剧	劇勮𠟵𭄏𭤜
副	疈褔㨽㽬𠠦
劃	划㓰𠞷𠟱𠟷
劝	劷勧勸𠠼𭄿
助	莇㫑𤋰𦔳𧴧
勒	泐勒𢳝𩉛𩩸
勖	勗朂𠡼𫦱𫦲
包	勹𠣒𭁳𮎛包
匆	匇忩怱悤匆
匐	𠣵𧼱𨄑𨄩𭅋
匓	䬨𠣹𠣽𠣿𫗑
匡	匩𬻻𭅕𭅖𭅘
匣	柙筪㭱𫭂𭅗
匾	扁𠩶𠪂𨖠𬄈
单	單𠦤𠫹𭆡𭈼
卖	賣𧷓𧷨𧷵𧷷
博	愽簙𩫯𫧤博
卮	巵𠨬𣏌𨆋𰰕
厨	廚㕏㕑𠾇𢊍
反	仮𠬡𢗰𭆥𰆗
叙	敍敘𣁏𪠩𫣮
叛	畔𧼦𪠫𭆯𭘔
只	祇衹隻𠮡𧙋
号	號譹𠳯𩖸𰈈
叹	嘆歎𡂥𧥞𪇽
否	不𠘶𠳝𬐹𬒷
吹	龡䶴𠷕𪛐𪛑
吾	𠮣𢓲𨖍𫊟𫊣
呓	囈寱讛𠾁𡂞
呕	嘔㰶𠴰𣢨𧖼
咅	哣㕻㖣㰯𡃠
咱	偺喒㑑𠴰偺
咳	咍嗨欬𠹛𠺡
啃	硍豤𠳁𡆟𱌦
喃	娚諵䛁𠲸𧦦
喧	吅諠𧮔𧮥𰴰
嗾	㖩𠲌𠻛𠻣𡂡
嘗	尝𠤠𠹉𣋈𬓂
噫	抑譩䪰𢤏𧮒
嚴	严厳𪠛𫝝𭌔
囂	嚣𠽸𪡼𰶳𰷃
回	佪囘囬迴𡇌
圆	元圎圓圜㘣
園	园𡈂𡈃𡈤𭁱
圖	図图𡄅𡈇圖
在	扗𡉄𡉈𡉠𥩴
均	抣𡉲𥘩𭎀𰼙
坎	凵埳欿𡑒𡸞
坑	坈阬𡊬𡌖𰉵
坚	堅䋌䋗𥪡𭍻
埙	坃塤壎壦𰊾
域	㚜㽣䧕𡌳𢨊
堂	坣隚㙶𬔢𰢃
堋	𡊤𡐐𥦜𫮙𭩀
堑	塹壍㟻𡐛𰝛
堤	埞隄䧑𡐾𪣙
堫	䎫𡒇𡒠𡓌𪤫
填	塡窴𡒆𥪧𰉰
墣	圤㙸𡑿𡓙𰋂
壼	閸𠁕𠆊𡔶壷
夤	𡖴𡖷𡖸𪫂𫴃
太	冭夳𡗔𡘙𣡳
夺	奪敚𠔟𡙸𡜎
奉	𠬻𢱵𣩌𪥐𫯠
妄	𡔞𡚶𧧄𭑬𭑭
妘	㜏𡛍𡞩𡤀𪔈
妙	玅竗𡭹𢆷𭒈
姓	𤯕𤯣𤯧𤯬𰋿
姻	婣𡛸𡜭𤯠𬉛
娉	婷𡞄𡞐𡞲𪦁
娱	娛娯虞𭑹娛
婴	嬰孆孾𦦿𭒲
嫭	婟嫮𡚯𡞛𡢙
嬭	妳㚷𡛾𡤘𫲅
孟	𡗖𣏍𥁝𥁪𰤳
学	學斈𡕕𭓕𭓘
孪	孿栾㝈𤲶𭓝
孳	孶𡥝𢀐𢇖𦈄
孺	𡥶𡦗𡦘𭮉𭮘
官	𠕍𡦹𡧟𡧺𮃻
定	掟顁㝎𡧡𢘫
宣	𠖚𡨈𡩦𫧑𭁴
宿	㝛𠫗𡪴𤛝𪧐
寐	𥦉𥦤𥧌𥧴𮄆
寨	砦𡍥𡎵𪧦𰌻
尥	尦𡯌𡯚𡯡𭀞
尳	㾶𡯜𡯠𡰊𩨔
尵	𠑌𠒺𡯺𪨇𫵒
尸	屍𠇣𡰣𫵖⼫
尻	㞍𡰼𡱧𦙷𫝲
屁	䊧𡲩𥤶𥥓𥧔
届	屆艐㧂䇒𠨴
屋	𡎔𡲃𢩈𦤼𦤿
屣	𦁡𩋀𩌦𩌳𭕫
岖	岴嶇㠊𡶦𡼆
峨	峩硪𠩙𡻍𡽥
崛	倔崫掘𡽈𭤾
崤	殽郩㠙𡵔𰎪
嵘	峵嵤嶸𡵓𡵦
嵯	嵳𠪉𡽓𡾑𰎿
巅	嵮巓巔𡻗嵮
币	幣幤迊𢄞𧸁
帱	幬𢃖𢄛𢅂𢅱
幒	𢁷𢃓𢃧𢃪𢃭
幹	干龫𠧄𫢉𭅪
度	宅㡯度𢜬𤸿
座	坐𢉰𫝶𫝷𮉴
庭	閮𠩢𨓀𨓍𫷳
庸	㐯𠆌𠆒𠭻𧆿
廧	𢊂𢊉𢋾𪪞𰐃
弘	𢎞𢗞𣧀𪪺𰇉
录	彔録𢑗𧧱𬺷
彘	𠅰𢑣𥏉𥏰𰕎
役	伇𠈧𠈿𪨍𬽹
徂	䢐𠭯𡲂𡲡𨖆
径	俓徑迳𠉰𢔉
徇	伨狥𠊫𠋹𢓈
怒	㣽怒𡀆𢘂𢜂
怜	憐㥕怜𢣶𰒡
怡	夷𫐜𫹸𫹹𰫨
急	忣㤂㥛𢚩𰑑
恋	戀𡆕𢣫𤕈𭟄
患	𢠶𢡙𢤒𨴮𭼢
悯	愍憫𢡥𢡻𪬖
惇	㥫𢚙𢤈惇𰒈
惕	悐惖𢞫𢡕𬊛
惬	愜㛍㥦𪫨𪫯
惭	慙慚𩉒𭟌𰖴
愁	𢙹𢛱𢝲𢶲𰂵
愩	慐𢝢𢠕𢣁𫺌
慧	惠譿𠀄𢜎𣮝
憂	忧𢚧𢞘𢟜𰳀
懋	茂𢘅𢠖𢠘𢡟
懫	𡏸𡒐𦥊𦥋𰑬
戏	戯戲𢧽𭟼𭟾
手	扌𠂿𡴤⺘⼿
承	𠄘𢌼𢪐𢪻𰔄
把	弝欛𢮤𢺞𩨜
抌	伔㪛㱽𢪨𢻼
抟	塼摶𢮛𢮨𢰋
披	翍被㩺𤿎𪾇
抽	㨨㩅𢭆𢳏𭢂
担	儋擔𠵆𥣲𧭃
拶	桚𢭓𢹵𣗁𪭜
拼	拚𢪴𢶳𧚗拼
拿	拏挐搻㧱𢮝
挽	輓鋔𢱍𮡺挽
捣	搗擣㨶𢶈𦦰
捶	搥槌𢈹𢴹𪮜
捻	撚焾㩶捻𢰀
揣	㪜𢭍𢯍𢰚𢵦
搄	揯𢫮𢬎𢰨𢳖
搅	捁攪㩭𭟁𰔤
搊	𢫧𢬞𢬟𢮢𫼝
搦	掿搻𢾲𢾼𰕛
撻	挞𢺂𢽞𢾴𪯎
操	撡𢮥𢻥𢿾𣀉
擒	扲捦㩒𬯭𰅱
改	攺㱼𢻰𨸩𪻞
效	俲傚効𭉯𭉲
敌	敵𠢗𢿪𰒰𰚇
敖	爊敖𢾍𫠤𫿑
敵	敌𪯐𪯔𪯙𰡦
數	数數𢾗𫾺𬣏
斛	㪶𧤰𫯂𭽎𮗤
新	𢀝𣂺𤗔𤗟𨐏
斸	劚𣂤𣃁𭤦𰕟
於	于扵𣱏𤋬𤕘
旂	𤞆𥙚𪯲𬝅𭤻
旄	嵍𢗳𣬵𣭅𫷀
旆	斾沛茷𣃩𬀂
旡	㒫𠑸𠘸𨀶⺛
旷	曠𣊥𣋷𣼥𧸼
昆	晜㒭𥊽𧲟𪢬
昊	夰昦皓𠕫𣆧
昔	㫺𣊦𤰻𥬅𦠡
是	徥昰𣆞𣊒𬅺
晨	曟辰㫳𠔹𬞀
曆	历暦曆𢍷𬓷
曼	㬅𠭒𣃸𭦗𭦟
替	㬱𤽽𤾕𧝆𰤚
月	囝𠥱𡇹⺝⽉
有	𠂇𢇔𪠥𰆲𰭿
朝	輈𣎍𦩻𨊸𰰎
构	冓構遘𡻉𣕛
枼	枽𣏋𣐂𣕫𭩠
柜	樻櫃鐀𣟧𣟨
根	𡉣𡉤𣏄𣏅𣒨
桥	墧槗橋𢱪𣘺
桨	槳㯍䒂𥶝𥷃
桶	甬𢳟𪟍𫦞𮃫
梳	㧧𣐌𣓜𣙳𤴜
棱	楞稜𣖓𤗷𭪄
椒	茭茮𣐹𣒏𣓙
楼	樓𡳫𣏥𩫰𰘂
榷	搉㰌𣓘𣙜𨢜
槎	查𠞊𣕗𣗩𣞚
樊	棥𡘽𤕩𫯹𬄀
檀	𣞀𩠽𫞍𫢀𭢤
檋	𣔑𣞶𣞹𣡴𰘈
欣	俽忻惞訢𭭄
欲	慾𡟔𢓑𣣔𭛨
歃	喢㰱𣣨𣣮𬐬
武	㱐䟼𢎁𢦰𭟰
歲	岁𢧍𢧡𫞓𫻴
歸	帰归㷌𢅨𰻂
歼	殱殲𣨦𤒯𰒬
殃	䄃𢈮𤸡𥙏𰚹
殪	翳𡔸𣨑𣩉𰊗
毇	𥶵𥸃𥼹𥽂𰫄
每	毎𡴋𡴕𣫭𤰗
毕	畢罼㪤𭂂𭺾
毗	毘𣬈𣬉𣬖𤰨
毾	㲩𣯚𣯾𣰅𧝅
氐	𢆰𢎮𢎶𰁘𰚷
永	𠘷𣱵𬽃𰀺𰛆
汇	匯彙滙𪶬𭍰
泰	㤗𡙌𡙥𣳾𬇦
洁	洯潔絜㓗𣳱
洒	灑𣶇𣶓𣹍𤂢
洪	潂㓋𤀆𤂘𤅏
活	𣴠𣸅𣽅𣿛𮝐
派	沠𠂢𠨹𣲖派
浇	澆𣴹𣷝𣻏𤀴
浍	巜澮𠘎𣲸𣴯
浓	濃醲𤂑𤅁𤅛
浣	澣𤃬𪾕𬐲𬑄
海	海𣳗𣳠𣴴海
涂	凃塗荼𡌘𪶅
淀	澱𣵦𪒮𮡆𰛸
淄	湽紎𣻲𰜔𰜪
淅	𣶁𥺚𥼔𪷀𰜱
淫	婬滛㸒𣽮𤥏
混	掍棍潉𡇯𣽙
渴	渇㵣𣊅𣊆𣹈
渺	淼眇𠋝𡙎𣺌
湔	𣹅𣾅𣾥𤏄𪷇
滚	滾𣸳𣺒𣽙𬈟
滟	灎灔灧𤄝𤅿
漪	渏𣺈𣿾𬉀𰜟
澾	㳠𣽑𣾣𣿔𤀱
濊	𣿄𤂾𤃴𭳟𰛦
濡	渪𠤦𣽈𣽉𩄋
炎	炏𢉘𤆌𤾃𰝹
炰	胞𤆫𤇗𤈖𫹾
炳	昞昺苪𤈃𰞁
点	嚸奌點㸃𭴙
烬	煡燼㶳䀆𤐖
焉	𤇟𩾏𭭘𰇭𰋵
煌	熿䪄𤌗𤌼𪏥
熜	焧燪㷓𤑢熜
燠	奥灹𣋉𤈯𤈰
爊	䥝𤏶𤒣𤓍𤓏
爚	𤍼𤐯𤓀𤓝𭨣
爷	爺耶𤕓𤕖𭒅
牂	䍧䍭𤖁𤙢𦎆
牴	𤘳𤙆𤙊𤚃𰠩
牾	啎寤逜𤕻𮗰
犒	䐧𤚸𨢓𩝝𰠖
狂	忹狅𢙌𢚇𤝵
狾	𤠥𤠹𤢻𤣇𥺈
猃	獫玁𡪯𡫉𭸅
猪	豬䐗猪猪𧳯
猫	貓𦲡𦲥𦻿𭸖
献	獻𤟜𤡎𭸣𭸮
玄	𠵓𢆯𤇡𤣥⽞
玤	䂜𠨵𢈦𤤓𤤵
玳	毒瑇鴏𤱢𫦚
珊	𤤪𤩀𥑬𭹅𰢂
理	李理𫩆𬎕𭮔
琉	瑠璢琉𤤭𭹗
琛	賝𤧪𤨺𧷉𰷈
璇	琁璿㻽𤥕𭥄
璘	璘𤥸𤧡𤧢𤪏
瓷	珁甆磁𤮀𦈱
町	甼畠䵺𤲖𰢶
畎	𡿨𤰕𤰝𤱶𰢸
畜	嘼𠬀𤛅𤠕𤲸
略	畧略𭛵𰢿𰣁
番	畨蕃𠔪𢇪𤲞
疥	㿍𤵇𤵏𤸋𰤇
疼	痋𤹤𤻴𤼆𦙭
痒	癢礢𡂺𤶪𤻰
痫	癇癎𣩝𣩞𤺛
瘎	㽸𤴴𤴺𤵔𤹛
瘰	疬癳𤻗𤻳𤼠
瘱	㥷𡣇𢟇𤸽𪽷
癃	𤵸𤶞𤷬𤸇𭙹
癘	疠𤻹𪽶𰒯𰤅
的	墑旳㢩𤾠𬐄
皆	𣅜𭥣𰲢𰲣𰲧
皓	晧暠皜𪡬𬐊
皰	𤿔𦡕𦫗𦫱𰤡
监	監譼𧗄𧨭𧩾
相	𢪷𥄢𨉽𰥚𰧳
睚	厓䝽𥊅𥌚𧡋
瞚	𥋰𪰖𬙜𬙥𰕼
瞠	憆矃䁎𥊰𥊲
瞲	䀗𥄴𥄵𥅛𥅜
矩	拒榘𫴙𭑌𮀁
矫	矯𠕧𥏹𰈳𰦝
石	䂖䄷𥐖𥐘⽯
砖	塼甎磗磚㼷
破	𠱀𡲠𭒕𰦥𰦻
碇	椗矴磸蝊𦩘
碌	磟䃙碌𮀮碌
碍	硋礙㝵𣝅𥃷
碑	碑𥓓𪿨𰦸𰧀
磲	璖𥑭𥓼𭫑𮁊
祐	鿆祐𥛒𨳾𨴜
祟	𣦅𥘐𥘣𥚢𥜱
禀	稟𥜘𪲪𫡿𰧿
禅	儃嬗禪䄠𮂟
禨	魕䤒𥘌𧝞𩴪
禮	礼豊禮𢢪𫌓
禼	𠨁𠨄𠨈𥜽𥜾
秦	𣜈𥘿𥠼𥢮𥣠
秸	稭鞂䕸𥞨𧅡
稗	粺薭𥟑𥟗𦓸
稱	称𥚳𬓭𰟾𰨟
穬	䊯䵃𥽟𪍿𰨜
窅	眑𥃧𥃯𥃺𥄀
窝	窩䆧𥦮𭓸𮄑
窦	竇𤅋𥥨𥥷𥩐
竀	靗𧡧𩇜𮄟𰩓
笃	竺笁篤䈞䔍
笮	筰䇥𥬚𥬛𥯧
笺	椾牋箋㮍䔐
筑	築𥬑𥬶𥬾𥴀
筥	𥮦𥰠𥱾𥷠𨟭
箔	簿萡薄𮅓𮅩
箸	櫡筯𣚰𥭻𥯄
節	节莭節節𥱳
簨	𣕍𥬷𥬹𥯗𫂎
籲	吁龥𥸤𮨣𱂟
米	侎𠂭𡭝𥞪⽶
粤	粵𠿋𡩭𫀫𫒀
粱	𣸑𥞹𥹭𮃡𮇹
糕	餻𥻷𥼯𩝏𩝝
糠	穅粇𤎖𥹺𥺧
紵	纻𥿾𦂂𦅷𦇃
絅	蘏䌹𢄗𫡃𬗶
綦	綨𥾎𥾟𦻆𭰭
緟	𤕌𤳞𦅅𧝎𫟆
縣	县県𬗫𮨑𰿞
纤	孅縴纖韱䊹
约	約𠣩𥾉𪪊𰫛
纳	内納衲𥾔𫨙
绉	縐䋓𥿲𥿷𦆜
绋	紼綍𥿏𦂓𩎛
绍	佋紹綤𦀧𫾸
缘	緣縁𢅞𰊍𰫾
缩	縮𣩐𦂨𦄲𦟱
缫	繅𦃐𦃨𦅒繅
罚	罰罸𠟑𠟟𦋬
罛	𦊡𦊬𦊶𦋆𭾱
羑	羐𦍶𦎅𦎙𮊢
羝	𦍝𦍞𦍫𦍿𫅒
羞	𡔨𦍟𦍮𭃱𰃤
翠	翆䕜𦐜𫩅𮋂
翳	瞖蘙㬾𦒭𩭅
翾	𦐽𦑰𦒠𦒬𩙽
耀	燿㿢𠓂𠓃𭀦
耋	耊臷𨊁𨊆𨊜
聍	聹𦗰𦡲𨊎𨊓
聿	粤肀⺺⺻⾀
肤	敷胕膚𤺧𦢚
肱	厷𠃋𠫔𠫖𠬟
胠	㫢𦚁𦚒𦛕𦛱
胫	脛踁𨁎𨂈𩩋
胹	𦓒𦓠𦠌𩰴𩱊
脾	腗𠧃𦜉𦜠脾
臛	𦞦𩞺𩟨𩟯𩟸
臣	𢘑𪟭𭰍𮍌⾂
臸	𫇏𬑴𬛳𬛶𬛷
船	舡舩𣍬𦤉𮎎
艐	䶽𣸌𣹇𦟨𦩇
艾	㘷𠚫𦫿𰰝𰰞
芹	斳菦䓅𣂼𧁲
茆	茒𦮉𦯄𦯆𦹉
茜	蒨𦴛𦵻𦻤𧀈
荽	𦬐𦬑𦯩𦯽𮏉
莘	𣘲𦸯𨐍𨐕𩺵
莹	瑩㼆𤐻𤫎𭸼
莺	鶑鶯鷪鸎𦿬
菡	莟䓿𣣖𦴻𦵀
萍	蓱䓑𦭃𦶊𬕘
萏	蓞𦻁𦽜𦾩𧂄
萱	萲蕿藼蘐𦯥
著	箸著𣋐𣥧著
葩	皅苩䔤𦲠𦺂
葱	蔥䓗𢚱𦯎𦵇
蓖	萆萞𦳈𦶃𮏰
薛	辥𦵮𧀼𧃎𮎟
薯	藷蠴𦾧𦿫𧄔
藤	籐䕨𦢘𬞳𮑚
虚	虗虛𠧝𧟬𮓡
虾	虲蝦𧋀𧎂𩹨
蛇	虵𥝀𧉮𬹟𮔃
蛓	䗹𧉠𧊸𧍤𧏀
蛙	鼃䖯䵷𡔩𡔻
蛩	蛬𧉨𧊡𧋄𧋳
蛬	𧊮𧋯𧌪𧎦𧏒
蜘	鼅䵹𧌲𧐉𧒊
融	螎𥃼𧖓𫋊𬴥
螫	𦔂𧋒𧏅𧐭𭌤
蟗	蝵蠤𧍾𧏋𧔭
蠆	虿𦹌𧍣𧓵𧓽
蠮	𧏽𧐷𧒐𧔦𧕪
衛	卫衞𩤸𬆏𭛝
衣	衤衣𰁤⻂⾐
袈	毠𣮫𣮱𧛣𮁬
袍	𣮃𧙌𧙘𫀆𫃠
裁	𣚸𧚝𧚶𫻭𬿢
装	裝𧙜𧚌𧚒𫌏
褐	褐𣮷𣯇𧝶𧝽
褭	䮍𠌵𩦫𬡇𮕹
視	视視視𬒹𬡼
覝	䙺𧡂𧡅𧡙𧡠
親	亲𧡿𪧭𫴏𰭎
觀	观𥍄𥍅𥍕𫟜
觝	𧣎𧣓𧣜𧤲𧤶
解	勼觧𦴘𮗨𮗮
言	𢍗𢍬𦉴𧩁⾔
詹	𢉲𦧕𧩏𭉵𮘐
詾	㕳𧦆𧦷𧧗𭿈
誓	逝䤱𡂉𣂯𣂶
誖	𠐲𢨋𧪶𫻸𰒲
誺	䜉𧨇𧩴𫍧𬣆
諕	謼𧩐𧫒𧬵𬤀
謑	䜁𠿇𧨞𧫟𰵾
讪	姗訕䚲𧧚𧧪
识	識𢨞𧥾𧨺𧬣
词	詞辞䛐𧥝𮍷
诖	詿𧫉𧬮𧭑𧭬
诛	誅㦵𫾭𬆤𰒪
询	咰詢𧩛𧪂𧪱
读	讀逗𡂝𧮡𬬊
谚	喭諺𠷗𧧑𮘷
谞	諝㥠𢝒𧩑𧫐
谢	謝㓔𧧬𧬄𮘴
谣	繇謡䚺䚻𫍚
谱	諩譜𧨌𧪻𧫭
谲	噊憰矞譎𭒠
豛	𧰱𧰵𧰶𧱕𧱣
豢	㹖𥏇𨤜𪺏𰶩
豤	貇𧱗𧱟𧱨𪙲
豺	犲𤝦𤞗𤠌𧲣
貤	䝯𥃸𥿫𧷆𰷠
貯	贮𫳇𫴝𫴡𬥤
貾	𧵇𫎛𬇊𬥰𰷢
质	儨劕質𧸲𪯎
购	購𧶩𧷻𧸊𰷋
贵	貴䝿𡭙𥅌𧶪
贾	估夃賈𧵎𧶦
资	資齎𢢾𧷕𪗓
赊	賒賖𧴳𧶟𮚎
赞	讚贊𮚋𮚏𰷣
赡	贍𧷘𧸸𩟋𰷜
赢	嬴贏𡧐𦢼𮚨
赦	𢼜𢽀𤆅𥘦𪯅
赫	爀𠅯𡎓𧹘𬟮
赴	䟔𨕍𪟾𫹏𬨞
趋	趍趨𧻫𧾶𨃘
趨	趋𧻌𧻬𪌫𫐻
跇	𧺿𧼪𧽁𧿰𧿱
跬	蹞䞨𣥮𨆆𨇪
跹	蹮躚𧿐𨇫𨇴
踏	蹹𣥗𤦊𨅵𫏘
踖	趞躤𨅦𨆮𨈁
蹀	𨁻𨂏𨅈𮜂𰸨
蹂	厹禸𠘯𧿪𫴀
蹰	躕䟞𢣵𨅒𨆼
蹲	墩墫𣦝𧿬𨀛
蹻	勪𨃧𨅳𨇊𫏋
躠	𨃛𨆳𨇨𮜧𰸷
軵	𨊭𨋠𨍷𩒷𰹿
輼	轀辒𨍆𨎽𫧩
轨	軌軓䡄𧗢𨑍
轩	軒𢆐𨍓𩋱𪪂
轻	輕䡖𨌷𨌻𨓷
辈	軰輩𠐡𠤖𨋅
辗	展輾𨏛𮝙𰍰
迤	迆迱𢕷𨒶𨽋
选	選𨓟𨕊𨕖𫑖
逋	𠆐𢌠𨓥𨕝𨗗
逵	馗㙺𨘫𩠒𫐫
遵	𢍲𢕰𨗕𨗖𨘊
避	辟𢕾𨓶𨕮𨕶
邃	䆳𥤼𥥇𮞼𮟏
邈	藐𨗿𨘅𨘷𨙁
邑	𡇃𨙨𬩴⻏⾢
邮	郵𨛀𨜚𨜲𨞄
邸	䣌𨚄𨚎𨚏𮟴
鄉	乡鄊𨞰𨞸𪤼
鄠	𨛵𨛸𨜄𨝘𨝞
鄮	𨝤𨞆𨞝𨞵𬪍
鄳	𨝪𨞚𫑡𰻵𰻾
酃	𨞖𨟘𨟮𨟯𰼂
酉	丣𫝁𬻕𮠕⾣
酗	䣱䣴𨠮𨠯𮠤
酥	𣍩𦢦𦣑𨢭𨣺
酾	釃𦌿𦍄𨠴𨢷
醅	𨟷𨠙𨡋𨡥𮠬
醒	㝭𡪟𢜫𨠠𩄆
醓	䏙𥁺𧖶𧖺𨡍
醜	丑魗𨢄𩳄𩳜
鈂	䤟𣜣𨥡𬬵𰲨
銎	𨥍𨥲𨧎𨩹𭤡
錞	𨪟𨫚𨯢𫓜𬭚
鍱	鐷䥡𨧲𨬘𰾕
鑹	镩𥎢𥎣𥎤𨭾
钧	均鈞銁銞𨥒
钹	鈸鋍𨦐𬫆鈸
铚	銍䬹𨧓𨧵𨫐
铺	堡舖鋪𠁃𤖑
锁	鎖鎻鏁𩪑𮢧
锏	鐗鐧䥜𨰓𨰝
锐	兑鋭𨦣𫒵𬓦
错	剒逪錯䥘𥕉
锤	錘鎚𨪼𨫻𨭇
镏	磂鎏鎦鐂𨪿
镝	鍉鏑𨫢𨬙𨮹
镞	鋜鏃䃚𥎫𥏀
镳	鑣䮽𧥍𨮄𩍶
闃	閴阒𨵙𨵢𨶑
闰	閏閠䦞𥹿𨷎
陀	阤𥞒𨹔𨹕𬽲
陉	陘𡷨𨹢𨺄𨺾
陖	𨺮𨻅𱀕𱀖𱀫
陛	坒㙄𨹼𨻘𰛭
隮	𨹶𨻕𨽘𫕅𬯀
隳	堕隓𢡣𮥠𱁀
雀	爵䲵𠋓𤍳𩾟
雌	鴜䧳䳄𣦘𩾰
離	离離𨾫𩀌𬯭
霹	礔礕𥒂𥗲𫕶
霾	䨪𩃻𩆲𩇁𮦦
靦	䩄𡆎𧡻𨡁𩈍
靷	𩍟𩍫𩍭𩍱𩎋
鞃	䡏䩑𩉦𩊎𫸭
鞋	鞵𩋔𩋘𩋧𰆻
鞞	琕鞸𩌛𩏂𮧚
鞨	㓭𠞃𧤠𩍛𩏌
韍	巿帗韨䘠𫖍
韡	𦾛𩋾𩏧𩏬𮧵
韩	韓㙔𡋶𩏑𰕬
韵	韻𡁩𧥺𧪼𩐝
頯	𩒟𩒶𩓚𩓰𱂬
预	豫預𥎀𧶃𩕓
颚	顎㬽䫷𩕦𩖀
餬	䭌䭍𩚩𩞵𫗫
饋	馈𫤀𫷸𬨷𬩫
饡	䬤𩛻𩟌𩟪𱄊
饼	餅餠䴵𦫏𮨿
馨	馫㯏䅽𡄈𤯒
驖	𩥏𩥳𩦷𩧀𬴋
骈	駢䮁𩡼𩢝𩤾
骋	騁𩢆𩢣𩣁𩧢
验	騐驗𣄝𩤼𩥾
骍	騂𤛫𩤑𩥍𬙮
骐	騏騹䭶䭼𩥕
骱	𩨢𩨦𩨧𩨪𩨶
骴	髊𣧨𣨁𩨨𩨱
髂	胢䯊𦝣𨂥𩩱
髹	髤䰍𩭘𩮄𩮥
鬌	䰇𨲕𩬻𩯚𮫄
鬷	𩰷𩰺𩰼𩱅𩱛
鬺	䵼𩰱𩱐𩱑𱆌
魯	鲁魯𩶑𬐰𬵉
鮀	䰿𩵔𩷿𩸻𬶍
鱀	𩵪𩷱𩽙𬶨鱀
鱦	䱆𩷼𩻷𱆻𱇸
鲧	鮌鯀𧣙𧣢𩩌
鲨	魦鯊鯋𩵮𩺳
鲸	鯨䲔𩼃𮔥𮬘
鳄	鰐鱷𧊜𧍞𩶍
鳢	鱧鱱𩷋𩽵𱇊
鳦	𠃉𩾐𩾩𫚮𱉇
鳶	鵈鸢𩾢𬷁𬷈
鴂	鴃䳏𨾕𪁠𱉔
鴳	鷃䳛𨾶𫛩𮬽
鴽	鴑𨾯𨾵𫛪𬷑
鶴	鸖鹤鶴𪅓𮭕
鷜	𩀮𪅛𪈜𬸞𱈲
鷻	𪆃𪆝𪈋𪈶𪈷
鸀	𩁍𪅱𪈌𪈺𱊬
鸉	𩁒𪃌𪇚𱈾𱉴
鸟	鳥𡖗𡗃𩾑⻦
鸰	鴒䴇䴒𩁎𪈝
鸲	鴝𩿩𪀊𪀠𪁖
鸿	鴻䲨𨾊𩾯𪅯
鹗	鶚𩀇𪀝𪄍𪅴
鹽	塩盐𥂁𬐱𬐻
鹾	醝鹺𪉬𪊁𪊈
麛	𪋃𪋈𪋗𪋸𱋂
麝	𤚑𤠭𥔡𪊻𪋧
麴	麹𪋼𪌗𪌬𪍚
黄	黃𡕛𫜘⻩⿈
黍	𥞆𥞫𮮐𮮑⿉
黹	䌤𧝉𮮠黹⿋
鼕	㲇𪔖𪔗𪔜𭽸
鼾	哻𠵸𪖟𭆺𰯶
齋	斋粂齊𠮘𥜷
齘	𪗢𪗣𪗮𬹼𱌜
齮	𠔵𡄘𪙴𬺈𱌡
齳	齫𪘩𪘭𪙣𱌳
齾	𦉟𪙿𪚊𪚋𫜰
龄	秢齡㱓𠎜𪗲
龆	齠𪗦𪘈𮯂𮯃
龋	齲䶚𤘐𦔊𮯌
𢑈	𢐥𢐬𢑂𢑄𢑉
𣀣	𣀨𣀾𣁀𧥙𧥚
𣄴	𠅽𡮎𣄵𣄶𣄷
𣐺	𠀟𢉫𣎺𣒚𣒷
𣮧	𣯊𣯓𣯞𣯟𤷋
𣶞	㳩㴂𣵢𣸙𣹼
𤇯	𤇷𤐷𥘙𧘳𫸢
𤉹	𤉨𤊨𤊸𤒓𤒜
𤲒	𡳧𤳊𤳫𤲒𢆟
𤲬	壖㽭𡑂𤳜𤳟
𤷻	𢉵𤶆𤶵𤸢𤺙
𤼙	癵𤹏𤼣𦣏𩪾
𥀖	𥀋𥀑𥀒𥀚𥀜
𥃀	𥂡𥂬𥂶𥃂𥃐
𥷚	𥯺𥰬𥱩𥲩𥷤
𦄼	綇䋶𦅓𦅨𬘳
𦖋	𦕥𦕴𦗊𦗙𨉡
𧡬	䚁𥉎𥉨𧠿𧡆
𧱦	𧱎𧱠𧱧𧲖𧳑
𧹼	𧹻𧺂𧺃𪜕𪴄
𨌅	𨋿𨍁𨍃𨎯𰹗
𩐌	𢌐𨽮𩈁𩐕𱂍
𩔊	𠨎𠨖𬛭𬱛𰆋
𪅮	𪁷𪂁𪂨𪄋𪄰
𪇰	鸔𩁠𪈚𪈫𱊲
𪌘	飳𩜶𪍍𭐨𱋍
𪍛	𪌔𪌯𪍐𪍕𱋒
𪍠	𪍢𪍥𪍱𫜕𱋞
𪘨	㗍𠵠𪘜𪙢𱌴
𪙉	𪙐𪙸𪙼𪚍𱌼
𪙤	𪘯𪘻𫇒𬺒𱌥
𰃰	𧱥𭸖𰃱𰏛𰣇
㓼	𠛨𠜀𠝱𠞘𠟴𰄯
㘑	𭋅𭋸𭋹𭋺𭋻𭌚
㝅	㳶𡔵𡭾𣫃𣫌𫯂
㲋	㚟𠕗𠜌𣬋𤟭𭯍
㺁	𤝾𤠏𧳀𧳦𧳺𧴙
䅀	𠞜𣏮𥞥𥟜𥟸𥣭
䆯	𡢷𡪋𡪚𡪧𩈽𫁙
䇓	䇕𥪃𥪙𥪥𫖠𰩧
䊲	𣠁𥽱𥽽𪉺𬡻𰫏
䐢	䐍𦚲𦛑𦛴𦜻𰮙
䡯	𨌪𨍈𨍉𨎢𰹜𰹣
䬫	𩚞𩚢𩚨𩛀𩜡𬲮
䮔	𩣷𩥗𩥨𩦁𩦛𱄺
䵎	𦓟𦓣𪎿𪏖𪏝𪏣
丛	叢樷欉藂𣜒𬅆
两	兩刄㒳𠓜𢎏𭃂
为	為爲𤓸𤔡𨤒𫞟
亮	倞亮𠅙𠖍𡔧𰎭
令	令𠊈𪟹𪵍𬔣𬗪
休	庥烋𠇲𠇾𠉉𬽼
伸	信搷敒𠈐𣃵𤕌
佞	侫倿𢜡𧦣𧩕𪜨
假	仮叚𠁒𪝒𬽥𰧌
偻	僂軁𠍿𠎪𡰌𨊖
充	充𠑽𠘺𬽇𭀚𠘺
兒	儿児𠒆𠒇𧠇𫤘
冈	堽岡𡇬𡶩𡷇⺱
凶	兇㐫㓙𣧑𭮌𭸂
函	凾圅㮀䤴𠚗𦥖
则	則𠞋𠟔𠟭𠟻𣉇
刻	𠚰𠛳𠜇𠞫𭄜刻
前	偂歬𠝣𣥑𫝐𰎗
剜	㱝𠛠𠝪𠞚𣪰𭃰
剪	翦鎆𠞳𠞽𠟠𣦃
动	動勭㣫𡺍𨔝𭄴
劾	勓𠛳𠜨𠡌𠡜𬥡
协	劦勰協恊旪𠦢
卑	卑𡭼𡮁𤰞𭅡卑
卫	衛䘙𠀄𫟘𫟙𬿭
历	厤曆歴歷磿𡿌
压	壓押𡑅𡒦𭏪𱅼
厌	厭猒𤞣𤡜𤼇𭼩
厦	廈𠩴𢇗𢌂𢌉𤹉
双	雙㕠䨇䨥𢅻𩀱
受	𠭧𡬳𢩦𣄁𤓾𪺍
叚	𠖊𠭊𤖰𪠪𬻷𭆬
君	𠀹𠁈𠱩𠱭𠱰𠺞
呦	㗀𠲭𠳘𠸰𣢄𣢜
呵	何嗬㗿㰤𠀀𠵩
咎	倃䛮𠧨𧧖𬉸𰇌
哄	叿閧鬨鿁𠹅𠹒
啖	啗啿噉嚪餤𡂋
啼	嗁渧謕㖒㖷𠸭
喝	欱喝喝𠿒𡀽𣣹
嘻	礂譆赥𡃨𣢑𮚿
坠	墜礈䃍𨼾𨽎𱁂
坯	𠂾𠃂𤇨𤬭𩎜𬴜
垒	塁壘壨磥㙼𡍸
埤	壀𡌨𡌸𡌹𡐕𡐫
基	𡉊𡉝𡉨𡉼𡋵𨄎
堰	偃墕隁𡍿𨻳𪣚
墀	𡎰𡒛𡓹𢹌𪼟𭏊
墺	圫𡋮𡌱𡐟𡒃𡶮
壮	壯壵𡉟𢎳𩡽𭍼
壳	殻殼㱿𪞱売𰚉
复	復複覆㚆𠰞𡕨
夸	咵誇𡗢𡗴𡘆𭑃
奄	奄𠘘𡘤𡘹𪥍𰤏
奋	奮𡘒𡚒𥂙𭑣𰲃
套	㚐𡘂𡘷𣺮𨻝𰋛
奶	嬭㛋𠂏𡇲𣍨𫡄
妻	𡜈𡜌𡜛𡝣𡝽𪥼
婆	㜑𡟖𡣩𢋉𫰷𰞹
婪	惏懢㘕𫱒𫿱𭒓
媟	𡛶𡜄𡝥𡢬𡤏𭸗
嫉	愱疾㑵𡜍𢞱𧪠
孝	𡥈𡥍𡥒𩱞𫗍𰭨
宅	厇㡯宅𡊾𡧜𡧪
宰	𠈾𡨔𡨧𡪤𣪮𫳐
宽	寛寬𡘚𡙤𡩖𡪨
富	冨𠖐𡧛𡧝𫲷𭁻
寤	窹𡨂𡨟𡩺𡬑𧄯
寮	竂寮𥨤𥨽𥶣𰩜
导	導𡭎𡭑𣜦𧘄𨗳
尤	尢怣訧𡯊𪾡⺐
尧	垚堯𠑐𠒖𡊪𡋰
尾	㞑𡱓𡱕𡱲𡲵𪨌
居	凥㝒㞐𡨢𧿃𭙍
屈	𡕜𡲒𡲬𡲶𣮈𰍾
屐	𡰵𡰸𡱪𡲆𭕞𰍸
展	㞡㠭𠌄𡱗𤲐𰍰
岡	冈𠆼𡶬𦊤𫝍𰃪
峰	峯琒𡵞𡶶𡷅𭖥
峱	嶩巎𡸆𡿚𤞍𤟁
崎	岖㟢㠌﨑𡼋𡼭
嵌	篏㘛㟛𥳽𭅜𮢞
嶭	𡶫𡺰𡾦𡾲𡿒𡿗
巂	嶲雟𡻎𡾧𪆳𪈥
左	㔫䶹𠂇𡯃𢀡屮
帢	㡊𠕣𢂿𢃫𧚧𩉉
并	並併幷竝𠀤𰏤
幽	𠫬𡋢𡴴𢇕𣾧𤄘
庑	廡𢇜𢋑𢋰𢋹𢌋
底	㡳𢇝𢇨𢇹𭕚𭙗
庚	𠩖𢈏𢈰𧟴𫷻𬅪
庞	厐庬龎龐龎𰆥
庾	㔱㢏𡩔𢈔𢋸𫭌
廳	厅厛𢌖𤘖𪪚𫳛
廾	㫒𠬞𢪒𢪙廾⼶
弋	隿𢍺𨾍𩾢𫠠⼷
引	廴㧈𢎢𢏂𢪉𫸥
彗	篲𥱎𥱵𥶙𬰙𰐤
彙	彚𢑥𢑷𢑺𣈎𫉂
影	景𢒈𢒬𤂖𪫉𭧟
征	徰徵𥘺𨒌𪨘𭛭
心	忄㣺𢗀⺖⺗⼼
忌	坖誋諅𢗂𢗹𢭄
念	唸悥念𢗁𫝹𫺐
怀	懐懷褢褱𧞷𰯨
怕	𢗌𢘣𢥻𭟑𭟘𰒟
恭	共龏㳟𢙄𢚈𦮡
悠	逌𡔀𢚐𢟅𢥀𢥙
惧	愳懼𢡔𪭈𮚗𰑌
愈	瘉癒愈𠃄𡩗𢠚
愿	願𢥧𩕮𩕾𩖂𩖈
慶	庆𢊋𢊤𢋤𢞢𫑭
憔	癄顦䩌𢤼𭵼𰤃
懵	懜懞瞢𢅴𢢺𭞩
戎	荏𠈋𢍻𢦛𢦦𫻳
戴	侢戴𢎑𢨇𢨚𱄌
户	戶戸㦿𢨥𣥘⼾
扃	扄銄𢇺𨩮𨴀𪭙
扇	搧煽謆㮼𢄒𥰢
扛	掆摃𢭈𢰌𢴦𣗵
扶	𢱿𢺻𢻳𪯈𭷀𰀣
拓	搨柝拓𢫳𢷌𢸨
拔	扷抜㧞𢪺𢬌拔
拥	擁㨣𢶜𢹬𢹭𢺠
捍	仠扞攼㪋𣑬𫷕
捏	捻揑𢯊𪮆𪵉𭡦
掣	摰𢊏𢮓𢳅𢳐𪘔
掩	揜𢲅𥤴𥦩𭡢掩
搔	掻㮻𢫼𢭒𢸪𤔢
搬	搫𢮽𢲎𪮥𬰝𮃝
摽	𢶏𢸂𢹰𢿏𦭼𰔯
撰	僎篹譔𢰅𢵬𪮵
攴	攵䇚𢪊𦬙⺙⽁
救	捄㤹𣪋𧘶𧧷𫻲
数	數𡢏𢿘𢿙𣀭𰚆
敷	尃旉㩤𢾭𢾾𪵐
斑	斒班辬𤨘𪻮𭹞
旁	㝑㫄𣃙𣃟𣃪𬀊
旃	旜㫋𣃯𣃼𣮻𰕮
旋	镟𡟐𢭀𩙢𭤱𭻾
昴	𣆻𣇅𣇯𬁬𭛍𭥦
晚	挽晩𣆛𣆶𣇋𣈳
景	暻㬌𬡿𬢂𬱉𬱌
暗	晻闇隌𣆛𣈇𪾲
曜	㬬𣇪𤒂𪏌𫞂𭀦
曶	㫚𠯳𡆳𡆷𡇆𦙑
最	冣穝㝡𣤜𥦡最
朵	朶桗䒳𣎾𣎿𣏻
来	來猍逨𧼛𰙬𰷷
杰	傑桀𣎶𤆖𤇍𤈿
林	林𫓞𫦜𫿧𬫫𬬟
柔	揉𡬢𣐱𣓥𭪗𰦍
栖	捿棲𡥠𢬔𣔃𤈇
桀	榤㘶𩣏𭪴𭫒𭫔
棗	枣𠂲𠄬𣕤𣕿𬃔
椸	箷㮛𤕮𤕴𤖌𥠥
楠	枏柟㭧𣐠𣑮𣔎
榼	醘㯼𣖁𣙥𥃕𨢸
樂	乐樂樂樂𠒴𣠋
樽	墫罇鐏𤮐𫑼𱀵
橐	槖𡇈𢄿𢅍𣓷𣕣
橹	樐櫓艣艪㯭𣙠
櫑	鑘𣠠𤴇𤴊𥃇𪴘
步	歨歩踄𡵯𣥶𰰦
歷	历秝歷𠪱𢊆𭚇
殂	徂𠹨𣧫𣨐𣨖𬆖
残	殘㱚𠡡𣧚𣧻𦚛
殺	杀殺殺𣪩𬨥殺
毡	旃氈氊𣭣𣰔𩎄
氤	絪𣱙𣱜𩂥𰚿𰛁
汪	㳹𣳫𣵭𣷪𪶁𭖧
沛	伂㳈𥙅𨙶𪵴𫥀
没	沒𠬛𠬸𣳚𣴬𦐲
沧	滄濸𣳁𣶟𤀅𰜤
洼	凹屲漥窪𣵾𰩔
浅	淺𣸶𣻝𤄻𪵷𭰦
渎	凟瀆豄䢱𤀨𨽍
湎	沔䤄𨟺𨡞𩈳𭰫
湩	𠄉𡣢𡦢𭓜𮠵𰁑
溜	澑霤溜𤄐𰜈𰜵
溪	嵠渓谿𡏛𤲺𥡙
滨	濱濵䧬𣴩𣵈𨽗
濒	瀕𤂔𤄹𩔤𩕘𩕨
瀹	汋㵸𠔠𤅢𤅰瀹
火	灬煷𤆄𬬊⺣⽕
然	嘫肰𤉷𤟙𭮆𰡀
煎	㷙𤋎𤌺𤎴𤎵𤐄
燃	然㸐䖄𤓉𤓌𧆋
燐	燐𤌠𤐪𤒑𦺸𧃮
牙	齖𤘆𤘈𤘉𨈏⽛
牢	窂牢𡕘𡘠𤘰𥥑
犅	牨𤚞𫅙𬌧𬳭𰠫
猛	𠩜𣓶𪹁𮃑𰅐𰡖
獬	𢖆𤛳𦎈𦏘𧳊𧴛
玈	㢳𢏾𢐸𤣧𪑄𪒓
玉	軉𠀛𤣪𥝍⺩⽟
环	環𡑡𤧖𤨔𤫐𨰄
瑰	璝瓌㻁𤤨𤩫𤪿
瓮	甕罋𤮲𦉥𦉨𬐷
甲	𠇚𡴌𤰒𦩀𫭂𰲤
畛	聄𤱏𤱥𤱼𤲆𬌅
畢	毕𤲃𤲜𪰞𭛐𰻐
疱	皰靤䶌𤶋𦝐𨠖
瘥	差𣩈𤻸𦏱𬏢𬏵
瘿	癭䑍𦡺𦢆𩖍𰣭
癊	𤶊𤷜𤸌𦜲𦝴𭼭
白	㿟𤼽𤽁𦣺𪞶⽩
盖	盍葢蓋𤇁𤇙𭾂
盭	𥃊𥃎𥃏𪾜𮕡𰊿
督	𣈉𣈌𥆳𥆴𰥥𰥾
睪	䁺𠬤𥇝𥇡𦎝𬙜
睽	䧶𠊾𧡫𨾎𨾗𬑪
瞟	𥋄𥋠𥌝𥍌𧢄𧢨
瞬	瞚瞤䀢䀵𣊬𪰖
瞽	𥌒𥌕𭿢𭿲𰏈𰦂
矜	矝鹶㥤㮗𥍵𥎊
砌	矵磜𡌇𥐛𭎄𮤺
研	揅硏䂴𥓋𥓨𭱍
碜	硶磣𥓗𥕁𥕃𥕺
碣	嵑嶱礍𡂶𡄌𣍔
碱	堿𥃡𨣇𨣉𪉦𬑻
磊	礌磊𡾷𥗉𥗬𰦫
磔	厇矺𡍎𡑙𨃥𭣊
磕	礚𥔐𥔽𥕤𭢕𮁇
祀	禩𥘰𥙉𥛴𥜥𬓚
祝	祩祝𥘱𥙐𥞏𩚶
祷	禱𥙤𥙸𥚜𥛇𥛈
秉	抦𣏲𥝐𦱮𬼌𬼞
种	種穜𥡰𥢖𦔉𧀑
秣	䬴𥞪𥡸𥤀𦾒𧀅
穴	坹岤𠕉𡧆𥤢⽳
空	𠀝𢦉𫞹𬜖𰁕𰌴
窖	𡑛𥥭𥥺𥦿𥧦𥧳
窜	竄䞼𥦻𥨒𨼉𮪠
笾	籩臱𠥣𠥫𨘚𨙢
等	䒭䓁𡬝𡬦𢌭𪜀
筋	竻荕觔䈥𦞬𮏴
筏	栰橃艠𢬩𦨷𦪑
箄	簰𠥉𥭆𥱼𥴖𨲥
篗	籆籰䈅𥸘𧤽𬖇
篘	醔𥬠𥭛𥮢𥰞𨡲
篝	簼𥯿𥱏𥲙𥵡𬬊
篦	笓箆𣐡𥰑𥰕𫞾
篸	𢹽𥮾𥱄𥲲𥳋𥶟
粲	璨𥹏𥹛𥺤𥽆𭽀
系	係繫𢁴𦃟𪺕𭶯
素	㕖𦁘𦃃𦃚𦅪𩝥
累	絫纍累𠫯𤳻𤴈
繁	緐䋣䌓繁𫧅𬉯
繡	綉繍𫃯𫃲𬗷𰬩
纔	才𦁨𦂯𦆳𦆵𬘇
纯	純肫㝄𠄤𥾑𥾴
线	絤綖綫線𦂷𦇫
经	坕巠經𤔕𦀇𦀰
绤	綌𢂲𥿭𦀭𦃁𦃛
继	繼㡭𥽠𦁚𦇓𦇡
绷	綳繃䙀䙖𦇜𧚸
缯	縡繒䌆𢅋𥃙𦀓
罗	羅𦋝𦌴𬼶𮉞𮗈
罟	䇢𦊖𦊙𦊟𫅂𮊁
罢	罷𠐌𦋼𧟽𮊒𮊓
罪	辠𡈚𤾐𦋛𦤖𫅄
罶	羀𦊑𦊗𦊿𦌁𮊚
羆	罴𥀍𥀡𥀦𥀧𦌲
羿	𢏖𢏗𢏘𦐧𫸟𫸦
翔	羏𦍤𦑒𫅦𫅧𫕿
翼	䋚𦏵𦐂𦒖𩙺𰭝
老	耂老𠄰𠈣𦒳⽼
耨	槈鎒䅶𦓶𦔘𧂭
肴	殽餚𦘬𦙩𦜂𦜚
胏	𡋜𦙰𦚘𦚙𦛎𦞤
胚	妚肧㚰𣆏𦙂𰮉
脀	𦚦𦛆𦛫𦛬𦞪𪱝
脓	癑膿醲𥂒𧗕𮜻
腴	𣧴𣨃𦚤𫆚𮫿𰮻
膊	禣髆𦡰𦢸𦣈𰯡
膻	羴羶䍹𦏫𦏬𦏭
臊	𦏛𦞣𦟄𦟅𦠨𩟎
臻	溱𦥇𧽕𫇑𬛴𬛵
舅	𠢎𤰧𤽲𦥶𦦊𭦉
與	与𦦲𫝌𫟋𫤰𭁇
航	斻杭𣃚𦨵𬅣𮎃
色	𢒸𣤻𬼜𮎛𮎜⾊
艹	艸䒑艹⺾⺿⻀
芒	笀䅒𠅇𥝕𦬆𪌁
苏	囌甦蘇蘓䔉𧁨
苜	𦤄𦤅𦭝𦱒𦴄𦴠
茝	𦯭𦯱𦶜𮎼𮎽茝
荆	荊𠛼𠞣𦮓𭱧𮏂
荐	洊薦𥤆𦿬𧂑𧄟
莅	涖蒞䇐𦲷𦴷𬕅
莔	𦮄𦯶𦱋𦳶𦴖𧏊
莞	唍萖𦯵𦰋𦲩𦸌
莳	秲蒔𦔌𦱎𦱗𦸎
萼	櫮蕚𦰉𦾊𫉞𰱹
蒉	蕢䕚𤆂𧷩𧸋𰷌
蔗	柘𤯈𤯋𧀹𬞈𰢩
蕲	蘄鄿龩䕤𥷋𭄚
薑	姜䕬𦷗𧅁𫊌𬞏
薤	䪥𣩶𧂊𩐁𬞃𭮞
藐	𦯦𦴭𦾜𧂀𬟈𬨯
藝	艺芸𬂤𬂴𬓣𬓺
蚍	𧔆𧔯𧔻𧖈𧖎𧖕
蚳	𧉛𧋗𧏁𧏔𧐏𨑉
蛔	痐蚘蛕蜖𧍚𮓻
蝒	𧉄𧉋𧉝𧍹𧏈𧒪
蝱	䖟䗈𧌦𧕕𫊤𰳐
螣	𦢅𧈩𧑞𧔟𧔶𧖍
螺	螺𤨴𥛧𧷳𮕗𮤄
蟊	䖥𧎻𧐘𧓿𧔨𧕑
衍	𥞟𧗠𬉃𬉅𬩠𮕢
衷	𠂻𧘴𧘼𧙙𮕪𮕵
衽	祍袵𢂧𣐅𥙛𧙨
袭	襲㦻𥫄𧟛𧟟𫴪
袳	袲𧘾𧚕𧚤𧛅𧛧
裂	裂𧙩𧙷𧚲𧛯𧛵
襁	繦襁𦇤𧚴𧝿𧟂
觑	覰覷覻䁦𡳆𧠢
訾	呰訿𢋀𤺒𧩢𧬟
讯	汛訊訙䛜𠱖𡀚
诔	誄讄䛶𧧈𧫖𧮢
诬	誈誣𦥁𧨆𧨈𧩄
诰	誥𠬳𢍎𧧙𧧞𰴱
诱	唀誘㕗䛻𥤃𦲃
谔	愕諤讍鄂𡅡𣤲
谰	囒譋讕𧬘𧮧𰵟
谷	穀䅽𡵾𪠲𭶻⾕
谻	𠊬𠌋𠌢𠍠𠫲𧮷
豜	猏豣𧱚𧲀𧲨𫯦
豵	猔𤡆𧱷𧲓𫎆𰶮
貂	鼦㹦𧲹𪔸𪔹𪔺
貉	狢貈𧲪𧳇𧴘𧴞
貔	豼𤜻𤠞𧴀𫧉𬆺
貺	贶𫌝𫢢𬥑𬥖𬹑
财	財㒲𧴶𧵤𧸄𰷊
贬	貶𡬲𦥕𦥘𦥧𧴷
贮	著貯𡪄𧵒𧵤𫎓
贯	毌貫䝺𢿒𧵗貫
贰	弍弐貮貳㒃𢎐
赃	臧賘贓贜𧷢𮚛
赈	挋振賑䝩𧵉𨉎
赉	賚𧶐𧶘𧶛𧷖𮚅
赋	賦䝾𧵐𧶣𧷲𮙼
赍	賫賷齎䝴𧶐𧷔
赖	賴頼顂𠘝𧡽𩓃
赝	偐贋贗𧸛𭆘𱁍
趄	且跙𧻾𧽀𨒚𰷳
足	𠯁𠯣𤴕𧾷⻊⾜
路	路𡽘𨁖𨱴𮛾𮞑
跳	趒䟭𧿮𨁓𨁔𨃜
踬	疐躓䠦𨂤𨆑𨆦
蹄	蹏𤚢𥪟𨀭𨂶𨄪
躯	軀𨈬𨊘𩪍𮝀𰁳
軖	軠𨋶𨌂𨌃𫏷𰹶
軬	輽㮥𠫿𨋒𫐊𰹞
載	载𡙺𢀃𪪋𬞛𬲏
车	車𠦴𨏖𩒷𫏳⻋
软	軟輭𥎘𨉿𨋃𨋚
轸	軫䡩𨋎𨋏𨏤𮝑
辇	輦𨍻𨘧𨘪𪳭𫏼
辎	輜輺𨍟𨎏𨎜𰹟
近	𠦋𠧣𢆌𣂠𣥍𣥪
还	還𢕼𨕔𨖞𨘣𮟃
迩	邇𨑸𨒛𮞘𮞙𮟞
逃	跳迯𧻏𨒯𨓖𨓱
途	墿涂𠆧𠇊𡒎𣥳
遂	㒸𨒉𨓸𨔱𨔲𨽡
遌	遻𨔺𨕓𨕣𨕬𮞮
邪	衺釾𤜡𧘪𨚌𭈳
邹	鄒𨛃𨛄𨜈𨜉𮠐
郎	郒郞郎郞𨝥𭅺
鄙	𨝚𨝣𨝿𪯮𫑣𰻴
鄡	郻鄥𨜇𨜑𨞶𰻮
酱	醬𤖕𤖙𨟻𨡓𪧷
醇	淳醕䣩𨠺𨣳𨣶
醍	䣽䬫𣾸𨠏𩝊𮠺
醡	𨡗𨢃𨢛𨢦𨢧𨣮
量	量𣊹𨤥𨤦𭨝𰅊
鉴	鍳鑑鑒鑬𨰲𨰶
鍦	釶鉇𤟽𥍢𥍸𰾢
鏺	㔇䥽𨦏𨨻𨫁𰼦
鑄	鋳铸𫟱𫳇𫳥𬑃
钳	拑箝鉗㪁䈤𨱫
钺	戉鈅鉞䤦𨥘𨬓
铄	鑠𡤤𤅰𨰤𩟧𮣏
锋	鋒鎽鏠𨦟𮢢𰽂
键	鍵鑳𨩼𨭙𮢱𰽢
锲	契挈鍥鐑㓶䤿
锷	鍔㓵𨫘𨬆𨬱𮧪
閻	阎𨴫𨵀𨵁𨵅𨶒
闪	炶煔閃䠾𤊼𩆫
陽	阳𠧊𪳷𫹖𬪌𬯆
集	亼雦雧𠍱𠓛𠦫
雠	啁讎讐𠵁𢛇𢢧
鞄	䩝𩊋𩋲𩍂𩎘𩎾
鞼	𩌃𩍨𩏐𩏡𩏱𱁹
韠	縪鞞鞸𥀕𫖒韠
韶	㲈𢨍𪔓𪡳𫫌𬰼
類	类類𩔖𩔗𩔫𬕿
顶	頂𧵜𩒆𩕢𩕩𩠑
须	須鬚𠾫𦔰𩓣𬱇
颋	頲𨗶𨘀𩑙𫸔𮟖
颓	穨頹頺頽𥣧𥤒
额	頟額𩓘𩓴𬱃𭃺
颦	嚬矉顰𡤉𨽗𩖓
餈	粢䭣𥻓𥻵𩜴𬲌
餮	飻𡝢𡞬𩚝𩚸𩚺
餰	䭈𩱃𩱡𩱤𬳆𮩄
饐	篒䓹䬥䭇𩚂𮩞
饛	䀄𥁚𥁶𩝬𬲡𱄈
饩	餼䊠䬣𦞝𩚤𩛹
饰	飾餙餝𩚍𩛏𩜓
饴	飴䬮𥹋𩛛𩛮𩞫
馈	餽饋𠩸𧷛𩟱𫗙
馎	餺䬪䭦𩞽𩟛𪍡
馐	羞饈䐰𦟤𩝭𮩊
馔	籑饌𦠆𧃊𩜹𩝁
馥	䫝𧄦𩡊𩡑𩡘𪐒
馽	𩡳𩢏𮩵𮩸𰒀𱅁
駂	𩡰𩡵𩢈𩣎駂𱅀
驳	駁駮䮡𩢃𩣄𮩾
驾	架駕𤙑𩢟𪯀𮝋
鬯	𠚊𢀺𢗺𥠴𮫖⾿
鬵	𢑋𩰿𩱕𩱠𩱩𱆔
鰋	䱧𩷑𩹽𩻖𫚢𱆶
鲠	鞕骾鯁𦛟𩹐𩺂
鳞	鱗䚬𥼭𧤳𩼩𩽂
鳣	鱣䱳𧖞𩼼𩽦𩽱
鷉	鷈䴘𩀗𪁦𪁯𪂬
鸦	雅鴉鵶𩿗𪀨𪀹
鸩	酖鴆䧵䲴𩾺𪀩
鸭	鴨𩿼𪀋𪀌𪁗𪁨
鹅	鵝鵞䳗䳘𡤝𨿍
鹆	鵒𨾳𨿜𩀑𪃪𮬱
鹓	鵷䳃𪀈𪂦𪂧𪂭
鹪	鷦𩾗𪆄𪆅𪆔𪇶
鹭	鴼鷺𩁐𪀡𪆽𪇸
鹰	鷹䧹𤸰𤼡𨿳𪇿
麯	粬麴𥶶𥷥𩍔𱋐
麻	痳菻蔴𦲬麻⿇
黐	粚𥹗𥺡𥼝𦡬𪐑
黑	黒𢜧𪐗𪐫𭴬⿊
黟	𢉬𣘦𪐚𪐣𪐭𪑁
鼋	魭黿𠀻𠒞𪓒𪓣
鼍	鼉𡁥𡄞𪓸𪓽𪛄
鼙	鞞𥀷𦗺𧯿𮋾𮝪
齇	皶皻齄𦟰𪖸𭽷
龍	龙龍𩙘𩙠𫑰⿓
𠊬	㑢𠌁𠙆𠫷𢛠𢜭
𢆚	䅐𠔗𠠅𡘸𢆬𢍫
𤚲	㨌𣪬𤛓𤛗𪺱𭷮
𤬷	𤬼𤭗𤭠𤭡𤭲𤭿
𥛅	䄂𥛽𥜑𧪭𥛅𰨏
𥾂	𥹕𥼸𥽛𥽣𥽮𮇤
𦉢	䍅𦉣𨯻𫇓𫬴𬜂
𦋡	䍒䍙𦊋𦊎𦊏𦊧
𧎾	𧌬𧐋𧐑𧐯𧑀𧕌
𩆷	𩁺𩂅𩃔𩃢𩆧𩇏
𩥴	𩦀𩦄𩦅𩧋𩧞𩧠
𪂆	𨾧𨿹𩀃𩀔𪆨𪉎
㚃	𠚌𠚓𠚟𡔫𡕂𡕃𡕈
㿉	㾯㾽㿗𤸉𤼊𥢢𰣶
䀮	𥆆𥆈𥆨𥆰𥇀𥇫𥉂
䆏	𥣢𥣾𥣿𥤄𥤅𥤈𥤑
䶲	𤱋𤱣𪚫𪚮𪚳𫜳𰣂
丐	乢匃匄𠣏𠣣𡴮𬺶
中	𠁦𠁧𠁩𠅊𠔈𡖌𫲹
丹	㐤㣋丹𠁿𠂁𠕑𢒈
也	𠃒𠃟𠔄𦫴𦬀𬻿𬼂
亂	乱亂𢮣𫬽𫲱𬔟𬔠
亏	虧㚀𡓰𮓩𮓪𮓬𮦱
亡	亾兦𠅁𠤭𬼖𰀄𰶲
亦	𠅃𠅄𡖋𡗕𢂯𥩖𫷃
亹	斖𠆟𠆠𣁪𣁫𤅣𬜃
仿	倣彷眆髣㑂㧍𩬝
企	㑫𠈮𧾺𧿍𨀣𬽾𱀏
伊	𠁼𠈽𠜧𠜰𦯴𰁢𰛠
佐	左𠇸𠡃𥙀𬌬𬧹𬽩
体	躰軆骵體𨉥𨉦𩪆
作	㑅𠆯𠈨𢓓𢼎𬆢𰆺
侮	娒㑄㚢侮𠆸𢘃侮
修	俢脩臹㣊𠗆𢔜𬲓
偃	匽𠍛𠍾𠑚𤑅𪜿𮈧
傩	儺𠉗𠫶𠹈𩘾𩙎𩴓
典	敟䓦𠔓𠔩𠔰𢻅𥮏
兼	傔𠔥𥡝𬻵𭆢𮏳𠔥
剐	冎剮叧㱙𠮠𢰸𭄖
剩	剰賸䞉𠝍𠟇𧷬𪟏
割	㓣𠛊𠛛𠛢𠛷𧗶割
剽	勡慓𠜥𠠧𡬽𡭓𬋥
劫	刦刧刼㤼𠉨𠛗𠞏
勉	免勔勉𠅦𠢖𪟟勉
勞	劳勞𠢸𫸢𫺞𬏙𬡤
勴	㔧𠢻𠢾𠣊𠣋𰅔𰕘
匙	㔭㮛䈕𥫽𨥌𪰯𫧈
卒	倅卆䘚𠥾𡧵𨒳𰠄
卜	蔔𠁡𠁢𰀠𰍨⺊⼘
卤	塷滷澛鹵𠧸𪉖⻧
卺	巹𢀷𢀾𢀿𢁇𧯢𧯷
厂	丆厈厰廠𢉒⺁⼚
厅	庁庍廰廳㕔𠫇𠫊
友	㕛𠬺𦐮𦐯𦫹𦬧𬁡
召	訋𠮥𠮦𥃝𫤧𫥦𬜁
向	嚮曏𡩉𤖽𥥩𭕜𰠒
吟	唫噖訡㕂䪩𠥴𫪜
吴	吳呉𠯵𠱵𡗾𡗿𤯂
周	淍週𠄗𠣘𠱬𭎈周
咩	吀哶芈𠰖𠴟𠸱𦬒
哑	啞痖𠴀𣣾𤷸𤹎𤺘
啜	吷哾嚽涰餟𠼣𩟫
喷	喯噴歕濆㖹𠴮𠽾
噱	㖸㘌𠻔𠼥𠽁𧬷𧮫
因	囙㧢𡆬𡇂𡈲𤇀𭍝
坤	堃𠔜𠔧𡘩𡿦𡿭𫶧
坼	𡍔𡍩𢯪𣂙𤇚𤖴𰞛
型	坓形𡌁𡌑𡌒𬌳型
垣	𥥣𩍻𩫧𩰵𬴠𭎤𱅾
埴	戠𡌴𡍠𡑌𡑠𢨀埴
執	执𠙜𢽞𦎃𪯎𬟰𬟲
壅	雍㙲㽫𡓱𡔏𢋊𬽜
夐	敻𡕱𡕳𡕷𢿌𤔫𭆶
夙	𠈇𠉢𠉦𠘵𡖊𡖕𣦽
奖	奨奬獎㢡𤍵𤟌𤟒
婚	昏㛰𡕼𡕽𡖀𡝪𤔿
婿	壻聓聟𡎎𡎨𡠸𦕓
嫔	娦嬪𡜷𡣑𡣕𡤁𨊕
嫩	媆嫰㜛𤯦𤯯𦠫𰢫
守	垨狩㝊𡧕𡬮𡬴𰡧
安	侒𠕷𡚴𭑨𰇭𰋵𰢲
寰	㝨𡕅𡩑𡩲𡪭𡫖𫤻
寶	宝𡫿𩇉𫴅𫴗𫴦𫴫
将	將摪𢪇𢪽𤕭𨟻𰠶
專	专専𠧡𫩄𫸜𬣋𰐰
屹	阣䇄𡵊𡵋𤣮𪨣𪨦
峭	陗𡌔𡹺𢮉𭖶𰎰𱀓
崿	㟧㠋𡼑𡼰𡾙𰎵𰎽
巉	磛𡷭𡸊𡺎𡽡𡿣𭗹
巡	廵循𡿽𨊩𨑾巡𰕀
巢	巣樔漅窼𤔥巢𰯹
工	㣉𠜝𢀚𢒄𢒅𬙕⼯
巫	𠮎𡷯𢀣𢍦𢍮𪚠𭘆
差	荖䁟𢀞𢀠𢀩𫅏𭅒
希	㠻𠬯𠬹𢁙𢁫𭤔𰇅
帧	幀㡠㡧𢂰𢅃𢹑𥨰
帽	冃冒㡌𥚕𧛕𫷀帽
幾	几㡬𢆻𢆼𨗂𭙌𰒨
建	迠㨴䢖𢌤𰙨𰭼𰻌
弑	弒𢎊𢎍𢎓𢦳𢨓𭚤
弟	俤弚棣𠂖𢦢𬼺𰰣
彩	毝綵采彩𣁝𥝞𰐩
徯	傒𠌜𢓽𥪦𧧹𧨍𮘧
怪	恠𠬭𢘪𢙨𢚬𪫦𰆷
恳	懇貇𡓚𢡆𢢽𧩺𰵁
悴	忰萃顇𢜙𤎋𱂕𱂘
惫	憊𢞎𢟡𢢑𢣍𤸶𤻚
憨	㦑𠐣𢦅𣢅𤸕𤺍𤼉
截	擮𠃲𠛍𢧵𢨆𢷿𫻼
戾	戻盭㑦𢨾𢿐𤟵𤡵
扁	揙藊鶣𠓫𡈯𡲜𫠫
抑	挹𠲃𢑏𢫽𢬃𰓡𰻟
折	摺㪿𣂚𣂟𣂫𣂲𣂹
抚	拊捬撫𢸮𢻬𢻲𨑑
抱	勽袌𢫎𢬘𪭷𭷝抱
拉	剌啦搚㩉拉𢰖𥩝
拗	抝㑃𢰃𢱇𢲷𫼡𰔏
拯	抍撜氶𢫑𢫒𢮋𰞼
挞	撻𢫁𢹗𨘈𩋅𩌉𩌘
挥	揮㩣㫎𢯷𢰄𢱳𨍂
振	𢈫𤚨𤚾𤚿𪣗𪪸𫸚
据	拠據㨿㩀𢴃𢷛𭢾
掠	稤㨼掠𢱊𫿀𰔡𰗉
播	𠤻𢿥𨤏𫾶𫿓𬅱𰪨
攸	𠇉𠇥𠈹𢻺𬰽𭣢𰁦
敬	憼𠣷𢾠𢿩𣀖敬𰕔
族	㞺𥎩𥎼𥎽𥏁𫞀𰦚
时	峕旹時㫑𡺞𣅱𰖃
昵	嫟嬺尼暱眤𡠷𣆓
晃	愰晄㨪𠒼𤒼𨉁𰣐
晓	暁曉皢𣇈𣉊𬀸𭦩
晴	夝暒甠晴晴𩄆𰕺
曹	曺㯥𣈅𣊛𣌼𣍘𫡼
杂	襍雜𣛜𣜫𣠛𨿼𰗣
条	條樤蓧𡠊𣒼𭛹𭢌
業	业䧨𤑽𤒍𪴨𫨱𰩥
槱	梄禉𣜃𤍕𥙫𪳝𬄇
模	桙橅𡆶𡘲𣝶𤏠𰱴
檐	櫩簷䦲𣚞𣡞𤖝𭢶
歌	哥謌𡃭𣤑𣤒𭤃𰙔
殁	圽歾歿没𣨏𣨨𭮈
殍	莩𠬪𣧶𣨈𦖀𦹡𩛞
汰	汏汱溙㑀𡊀𡊌𰛔
浆	漿䊢𤕯𤖅𩝫𩝴𩞟
浩	澔㬶㵆𣽋𤅆𤅡浩
涛	涭濤𣵬𣾭𤁟𤃕𭱹
淑	㳤𣷕𣻪𪫥𭂑𰛧𰜓
淳	湻醇𠩭𣹾𤂸𬙸𭂓
清	淸㵙𠗜𢴆𨓽𩇝𰛓
溺	氼汋㲻溺𡲳𣲙𤀂
漏	屚漏𠗬𢉀𣼣𣾡𰍽
澍	霔㴻𩆩𪷏𫥙𮦵𰜍
濬	𣼂𣽊𣿰𣿼𤀹𤂓𤃒
濮	𣱶𣾴𤀾𤂛𤃊𤃙𨽂
瀛	灜𤄞𤅀𬉑𬉩𬉫瀛
灭	滅烕𢛣𢦹𣸵𣹹𰟠
炮	奅炰砲礟礮𰞑𰽎
烄	烪𢽻𤉧𤉺𤊮𤎦𤐳
烹	亨𤈽𨢶𩱋𪸿𬊧𬴻
烽	炐熢㶻㷨㷭𤇺𤑊
焚	炃燌燓㷊𤆶𤊩𰋧
焦	燋蕉㸈𤊙𤓪𤓬𩵰
熊	熋㷱𤌶𤠗𧰯𪏛𭳢
熛	䙳𠔂𤌑𤍟𤍭𤐫𤒾
燦	儏灿𤌴𤍝𪞆𬋁𰟬
爆	𤆊𤋪𤑥𤒁𤒺𤓊𪹼
爇	焫𣁞𤑔𦳼𦶟𬋖𭶢
爝	焳熦爑𤓄𤓡𪺄𪺆
爪	爫㕚爫𤓰⺤⺥⽖
狖	貁㹨㺠𤝨𤟊𭷻𮙧
狝	獮𤣐𤣔𤣗𤣝𤫏𭸄
独	獨𤝠𤟩𤠢𤡴𤢜𨊒
狭	狹陜陿𠩘𣇍𰃘𰡍
璿	䥧𤩅𤩋𤩡𤪻𤪽𤫀
瓠	瓡𤫸𤬄𤬗𪼵𫈻𭑦
瓦	𠩅𡧗𤬦𭀝𭂬𭺛⽡
用	𠂦𠂵𠛁𡶤𤰃𤰆⽤
甾	畠㚎𠙹𠙾𠚀𠚋𰃰
疏	疎踈䟽𤕟𥿇𦠦𨘖
痈	癕癰㿈𣋿𤻕𰣳𰯩
瘗	瘞𡈾𡎶𢊃𤺦𨻊𨻏
皎	晈皦賋𡙎𣈁𣎣𰋩
盤	盘𥂐𫨕𬐫𬐯𬐶𬰝
目	𠫕𡆲𡇡𥃦𥆤𭍞⽬
矧	矤訠𥎧𥎪𥎯𥏖𫨸
砭	𥐗𥑁𥒟𥓦𨥧𪿜𰦤
磬	殸罄𡔝𣫆𥓕𰋌𰧋
示	礻𡭕𥘅𧵋⺬⺭⽰
祖	祖𤓵𤔈𥘲𫨶𬃁祖
禋	䄄𠖦𡫻𥛡𥛿𫴖𬪭
穑	啬穡穯𢋦𥢺𥣱𰣋
童	僮𥪽𥪿𥫍𨚯𬔥𰩨
笨	倴坌夯㤓𡍋𡿶𢜘
筮	簭𡋍𥰫𥰰𥵼𥷂𥷣
管	斡筦𨵄𪧶𫴨𬮔𮅬
篆	蒃𡩚𥲰𥴎𪼄𫁾篆
类	頪類类𣈪𩔧𩔬𮨔
粟	䅇𠧼𥟫𥸫𥹟𥻆𥾄
粮	糧𣊼𣛀𥣷𩞯𮇜𮩓
纲	綱㭃䌉𣏈𣓡𦂴𭩡
绰	抄淖綽繛𤚷𦅕𦈀
绳	繉繩𦃰𦃻𨭘𫃧𬗝
缅	緬𤚛𤟯𥾝𥿶𬗟𰬄
缠	廛緾繵纏纒𦆑𫮈
缮	敾歚繕㪨𦆇𦆏𦆶
罔	㒺𠕏𡦽𡧏𣥙𤣴𦉰
罥	𦊰𦋀𦌄𦌾𦍃𦍆𬚰
罦	䍖𦊠𦊦𦊾𦋄𦋵𮊑
羔	羙𦍚𦍱𦎴𦏠𦏦𮊲
群	羣䭽𠹩𡲻𤛭𨐚𰻚
羸	𤼘𦏝𦢗𦣄𦣉𬢙𮊷
考	丂攷𢎿𣧏𦒱𫨲𫷟
耆	𥄥𦒿𦓀𨚻𪰚𬚋𮋝
聊	㗦𦕅𦕬𦕵𦕼𦖂𦗖
肰	𠤀𦛡𦛦𦝸𬁰𭨬𰮩
背	倍偝北揹𧶙𪟪𰮔
胜	勝𠙟𠢧𡕲𢾶𤯝𰮛
胝	疷䟡𤵋𦙁𦙘𦙠𦝔
脱	侻捝敚脫𦚳𨉋𬚜
腆	倎㙉䐌𣇺𥳫𥵶𥶚
腊	臈臘𦝙𦞽𦠪𬛄𰮠
腌	醃𦛞𦜽𦞴𦟩𨉚𨢴
腐	焤𢉶𢋲𣩇𤸗𫙆𭬙
腻	膩𦡸𧸉𧸐𮚞𰖡𰮓
臀	臋𡱂𡱒𦜴𦞠𦟓𩪡
臘	腊臘𦠼𦡓𦡔𦡳𫞇
自	𥃭𦣹𦣼𨈻𩐍𪞶⾃
至	𡉰𡊏𦤳𦤴𦤵𬛱⾄
致	緻䑒𦤶𦤹𦤺𦥀𮍡
舀	抭𤔘𦥝𦥞𦥟𦥨𦥵
舂	㫪𢪠𣇃𦥴𦥽𦦁𦦓
舄	舃𣚔𤉱𩊿𩍆𭴷舄
舞	儛𢷵𣄳𦏶𦐀𦨅𮎁
良	良𡆨𡰩𣌣𣌩𥭣𥭷
芑	䄫𥝗𦫾𦬊𦯸𦸆芑
茂	懋楙㮊䓮𫁸𫇮𭟱
荡	潒盪蕩蘯𠎯𣿘𧑘
荪	蓀䕖𦳪𦺈𦽙𧂍𧆙
莫	䒬𢍋𦮅𦱤𦱴𦶛𫂁
菑	葘䎩𦵰𦸜𧀗𮐎𰱢
菱	蓤蔆䔖菱𧁽𧅊𮏀
蒯	䓒𠣯𠣲𦮍𦰵𦳋𦹣
藕	蕅㒖𦸲𫀽𬕽𬚑𬟍
藜	蔾䔧𦺙𦾅𦿺𦿾𧅏
虫	仐蟲䖝𮓰𮓱𮓼⾍
虹	𢀔𧈫𧈬𧊋𧌫𧍺𬁅
虿	蠆䘍𧒨𧔐𧔱𧔴𧕧
蚁	蛾螘蟻𧍽𧑢𧔮𧕶
蝎	蠍𥗧𧒤𧓃𧔄𧖁𩫲
螽	𧍸𧑄𧑆𧑬𧒟𧔔𧕠
蟘	𧈱𧈺𧎢𧎬𧏪𧑰𫋌
裙	帬裠𢂽𢃆𧛬𫌔𬡝
褾	𢅚𥘤𥛦𧘡𧝪𧝼𧟈
觅	覓覔覛𥦀𧠘𧠙𧠨
触	觸𡝈𡟌𧢶𧢻𧣈𧥘
變	变䛀變𫖘𫴥𬢢變
诊	覙診𧠝𧦜𧦽𧧂𧭉
话	話諙譮䛡𦧵𧔗𧨥
诞	唌訑誕𦋪𧥡𧨓𧩙
谋	呣謀㖼𠰔𢘓𢜯𧦥
象	𤉢𤊱𤡸𧰼𪹌𬂏𮙞
贙	𧷠𧸾𧹁𧹂𧹆𬢆𰷮
贤	臤賢贒䝨𠤕𧷙𬥎
败	敗贁䢙𢼷𣀕𤖐𰶹
货	貨𣱷𧴦𧵰𧷈𧷴𫎔
贼	戝賊𢨗𧵪𩶺𮚆𰒭
赆	賮贐䝲𧴾𧷇𧸬𩟝
赜	啧賾𡁃𡁦𡄙𦣱𧶷
赤	灻烾𡗩𤆍𤍢𦮰⾚
趑	赼趦䠖𧾕𧿞𨀥𨒮
趣	𠮋𧺥𧻃𧻽𧼈𧼝𧾉
跋	茇䟦𥑕𧺺𧿡𭼀跋
跸	蹕驆䟆𠌫𡁘𢕏𧫤
蹶	蹷𧽸𨄬𨇭𨇮𩦒𪨡
轭	扼枙軛軶𩉴𩊢𫏸
辣	辢𦎖𨐜𪲿𫐛𬨗𬨛
逌	𠧠𠧴𠧷𨓘𨔁𨔖𨔟
遭	傮𣩒𨗐𨘜𨙠𮞯𮞸
那	郍䢷𢑽𣟎𨙻𨚉𨚗
郁	欝鬱𦉚𨚺𨚼𨛼𩰪
都	都𨛷𨜁𨜞𨟞𮟾𰼁
酸	痠𨠡𨢽𨣪𮭬𰼉𰼎
钘	鈃銒㐩㼛𦈨𦈵𨨵
铿	揁硻銵鍞鏗㧶𮡸
锹	橾鍫鍬鐰𠝡𣂁𣂥
闭	閇閉閟𨳯𨳰𨳲𨵰
陟	徏徝𠉡𠌹𫨞𰂮𱀒
陶	匋𥓮𨹋𨺃𫧀𬯈𰉷
陷	埳臽陥䧟𨺂𨺻𫅎
随	遀阥隨䢫𨓔𨔳𨼕
隐	隠隱𠃊𤔌𨼆𮁉𮥚
隰	㙷𨻋𨻥𨻸𨻽𨻿𫠃
雾	雺霚霧𩄯𩅗𩅬𬰇
霤	廇𣠚𩅐𩅑𩅸𩆎𩆞
靴	鞾𡲲𩋖𩍇𩍍𩎁𰆳
鞟	鞹䩹𩋻𩌒𩌞𩌼𩎏
鞯	帴韀韉𦆉𦇩𩋋𩌵
韅	䩙𩌹𩌺𩎌𩎍𩏞𩏰
韗	䩵𩋢𩍹𩎨𩏅𩏆𱂈
韘	弽㢵𢏲𢏼𢐇𩏁𱂊
韧	仞牣肕靭韌䏰𭄵
顾	故頋顧𩒒𪄮𬽬𮨇
颊	脥頬頰𡖳𩔯𩠗𩠣
颔	頷顄䫲𠹄𦜆𩩂𩩊
颜	顏顔𦫞𦫤𦫨𩓲𩕝
飘	票飃飄𠠕𩘔𩘞𩙞
餐	喰歺湌飡䬸𩛳𩜨
餗	𩞌𩞍𩞕𩞸𩱖𩱫𫗧
饘	飦䊕䬤𢐹𥼷𩛻𫗴
饵	咡餌㢽𧊗𩚪𩛣𩱓
马	馬㡍𢒗𢒠𢒧𩡬⻢
驼	駝駞驝𦚐𩢊𩣾𩧐
骀	駘𩢠𩦽𫹸𮩻𮪁𱄑
骝	駠駵騮驑𩣒𩤃𱄖
骡	騾驘䯁𦝠𦟀𩦻𩧣
骸	䠹䯐𡱍𩩏𩩰𮪩𮪪
髡	髠髨䪲𡧉𩫼𩬌𩭋
髦	𣬾𨱞𨱢𩫷𩭾𩮼𱄒
髭	頾頿𣯃𨱲𨲝𨲦𩑽
髻	䦇䯻𣯦𨲡𩬩𰿌𰿑
鬇	𨲌𩫿𩬒𩬓𩯎𩯩𩰅
魍	蛧䰣𧪵𩖩𩲛𱆜𱆠
鯬	䱘𩸢𩺸𩻌𩻳𩼽𫚞
鲁	魯𢻛𣥐𨟇𭦌𮫲𰗀
鲜	尟尠赻鮮鱻䲆𰴆
鳖	蟞鱉鼈龞𪔀𪛆𬵄
鷫	鹔䎘𪂸𪄑𪆭𮋕𱈷
鸋	𩁔𪅢𪆢𫛢𬷋𬷌𱉂
鸢	鳶䳒䳣𩾭𪀝𪃘𫼃
鹑	鶉㝇𨿡𩁛𪂎𪆾𱈬
鹘	鶻𩾤𩾥𩾲𩾻𩿆𪆸
鹿	廘鹿𢈘𢉖𢊩𮭱⿅
麨	𥹔𪌕𪌬𪍉𪍑𪎊𱋏
麰	𦭷𪌚𪌸𪍓𪍘𪍫𮮇
黻	𠕯𠮂𦓗𫩋𬋾𬖬𮋟
黼	𤰍𤰐𦓞𧁡𩠤𪩾𮓕
龈	齗齦龂㸧𧢟𪘟𮯅
龊	竐齪𪘏𪘛𪘮𪘸𮯇
龢	𥣃𥤉𫨘𫪡𬰻𬰾𮃰
䝐	𤡪𤢍𧱞𧲆𧲑𧲗𧲚𰶭
䭱	𥞕𩠿𩡀𩡅𩡈𩡙𩡟𩡡
䵶	𡳟𪓞𪓟𪓩𪚶𱋼𱋽𱌁
与	與豫𠔔𢌱𦥸𭁉𭁕𮍭
专	叀專𠧢𡴁𡴗𡵏𰆄𰞆
亟	极𠄸𠄹𠯉𤊅𦱩𦽯𬼿
人	亻𠆢𠔽𤯔𦉪𦉫⺅⼈
仆	僕㒒䑑䞜𢖃𢸰𬐖𬿵
兆	宨𠧞𡉵𡊥𬼙𬼚𭀡𰃊
兑	兊兌𠏮𠫞𫎙𭀘𭀙𭀜
冠	𠖁𠖌𠙙𠜍𢃙𦯿𪞒𭁺
凌	夌淩陵凌𠗲𣎎𣣋𭰗
凭	凴慿憑𠌩𠙖𠙥𡔟𢶚
刺	刾朿莿㓨刺𣐁𪑟𰀠
剿	勦摷𠞰𠟘𠟾𠟿𠢶𰒱
勇	勈㦷勇𢦨𪳆𭄫𭟵勇
勠	勎戮𠝧𠢜𠢯𢑕𤨍𪯖
匏	瓟鞄𠣻𠣼𠤃𦾀𫉌𫯯
危	厃𠝰𡴲𡴸𡴻𡵁𭅐𭘊
卵	卵𠨫𡖉𤓲𫑙𫧼𭮇𰆎
厩	廄廏廐𠙔𠤙𣉑𪠔𰆤
去	厺迲㚎𠇯𠫟𠫥𠬑𬅻
及	乁﨤𢎜𨕤及𰃋𰙟𰻍
叔	𠁮𠦑𡬟𡬧𡭫𢆑𥸩𭣬
台	檯臺辝颱㣍𠘭𡐬𬨚
吁	籲訏𠮞𠮱𠮲𠯊𦘼𬅞
含	唅𠲒𡇜𪢪𫩧𭁦𭇥𭮕
哉	㢤㦲𠳆𢎋𢦒𪪋𪭋𫧠
唤	喚喛嚾𠿅𡅱𡅻𡅽𧠮
喟	嘳㕟𠣠𠣱𠷝𠿥𡃪𢼾
嗅	嚊臭齅㗜𥈍𪕿𪖻𭊴
嗜	呩啫耆𣉟𦞯𨢍𩝙𭋦
嗤	蚩㰞𠱟𠷣𣣷𧏬𫪻𭉕
嗥	嘷噑獆獋獔䝥𠰘𠶪
器	噐器𠾖𡄛𥂍𦈯𫩏𬑀
嚣	嚻囂㕺𠑪𠾯𡆔𩫂𩫳
图	啚圖圗𠚎𡇩𡇫𡇴𡈖
坍	㘱𡉱𡊢𡔃𢪡𣲕𣲹𫮩
坛	埮壇壜罈罎䃪𡊨𤮦
垔	𡊹𡍏𡍯𡎄𡎱𡐲𡓓𦦋
夜	亱𠀸𠙇𠙑𡖍𤝇𬉹𭺡
夷	侇㹫𡗝𡰥𢎯𢓡𬻒𭑅
奸	姦姧𡝎𡟗𢙶𢛝𪙨𭒋
妆	妝娤粧糚䊋𡝂𡞓𤖩
实	実寔實𡧑𡧠𡪲𡫵𡾍
害	遏𠕛𡧱𡩐𤇵𭓯𰀘𰨚
宴	晏燕讌醼𡩷𤃇𮩘𰩖
寥	廫㡻𡪹𡫝𡽟𡽦𥧯𥨞
尘	塵𡐪𡑁𡒲𡔚𦧄𪋻𰊤
尴	尲尶尷魐𡰉𡰛𩴁𩴵
屏	偋屛幈庰𡲄𡲓𢉟𫵚
属	屬䜴𡱄𡱆𡲇𣀻𭕭𰍱
岊	𡴱𡴹𡴺𡴼𡵆𡵒𡷦𡸎
岐	㞿㟚𡌼𡵨𡵲𡹉𨙸𪨵
岗	崗㟠㟵𡹏𡹤𨹽𭖣𰎮
崟	崯碒㕂𠪔𠪘𠪚𠪬𡷧
嵽	峌崼𡹭𡺑𡻜𡻺𡼄𫶇
巇	隵㚀𡾞𡾟𢋼𭗩𭗲𰎻
州	刕𠂗𠃕𠄓𠚴𠛏𢏝𣧓
巟	㠩㵁𡿫𡿬𡿰𡿴𢇟𣺬
师	師𠦵𠵀𢂖𢃋𨸲𨸴𩇱
带	帶㡖㿃𢂸𢃄𢄔𦄂𭘧
幸	倖羍㚔𠂷𠦡𡴘𢆎𭎎
幻	㕕𠄔𢆱𣥌𬑬𭙈𭙉𰀥
廪	廩㐭𢈺𢊣𢊬𢋏𢋕𪪨
弃	棄𠆉𠔚𠬇𢍞𣓪𣫱𨓋
弢	㢭𡸅𢎼𢏫𩎢𭚱弢弢
徵	徴𢽠𢽡𢾷𢿁𧗲𫪇𭗓
志	誌𢖽𢖿𢗍𢗱𢚨𮥂志
恒	恆㔰𠄨𢂡𢗶𢘆𢛢𭨤
恤	卹賉䘏𨟰𫀉𭜛𭷞𰷉
悫	愨慤𢠛𢡱𢢢𢢿𢤶𧰝
惄	愵𢙤𢜷𢞔𢞤𧖷𧗂𩚮
懿	㦉㦤㱅𡕆𡤵𢢶𢤥𫻢
戟	孑棘㦸𢧢𫒊𫻩𫼄𬀃
扬	揚敭飏䬗𠀵𣈟𨱝𭭐
抛	拋𢬐𢱍𢱹𢿏𥒙𪭹𰦮
报	佨報𡙈𢭮𨖦𨖪𮎙𰺦
捆	祵稛綑𡈢𡈳𢮖𦄐𦓾
授	𥠢𥡑𥡾𥢓𥣍𫺚𭹯𮃏
掬	匊𡙳𢌻𢱬𥵱𥸭𥸶𰏮
揭	掲搩桀楬𡤒𢶆𢷒𢷔
携	儶擕攜㩗㩦㽯𢹂𰓊
撑	摚撐橕牚䟫𢴤𣥺𩞦
斁	歝殬𣀇𦌙𬐇𬙜𭣧𰠈
斟	酙㪸𣁱𨠇𭅧𮌅𰅽𰼄
旒	斿旈瑬㐬㫍𣽩𦀠𰕪
旗	旂綨㙋㫅𣄃𣗍𥛏𰭞
昃	昗𠩡𣅔𣅛𣅦𣅳𪰖𬀯
昭	佋卲巶炤𪰒𫞃𬁤𰞔
栽	㘽𣒭𣔮𣖋𥯒𦳦𭢚𰧸
棋	棊樭檱櫀碁㯦䃆𬄛
槊	矟銏㮶䔠𢍥𣓞𣔒𪲫
樯	檣艢𣝿𣞋𣞱𣞸𤕽𰔉
毅	䝘𣪣𣪴𣫖𣫚𤝈𬆫𬆲
毒	𡴛𡹆𤯟𥲮𦸕𧉉𫦚𭖪
毹	毺㼶𣭴𣭵𣮵𣯁𣰎𣰟
氀	㲎𣭇𣯫𣰝𣰢𭯟𭯫𰚦
气	暣氣炁㫓𣅠𤽍𰚻⽓
氣	气気𣱖𣱛𰀰𰅓𰚾𰟅
污	汙汚䵦𡜂𡜡𣱾𣽏𬇢
治	乿冶𡭒𣳮𦠋𰏰𰛜𰫨
津	𣵏𣸁𦨱𦩨𦪉𧗃𨔥𰰓
涧	澗磵礀㵎𡼏𡼥𧯎𧯑
湿	溼濕𣶖𣺝𣺯𤀟𤂽𤃁
滩	潬灘𤁤𤅩𤅼𤅽𭳊𮁙
炙	熫䏑炙𤐬𤒗𦛧𦜡𬉹
炱	炲㷘㸀𤆃𤐮𤐽𤒞𫨐
炽	熾𢧾𢨙𤎷𤐦𥏛𧹹𫤶
烂	燗爛爤㱫䑌𣩼𤏐𧟋
热	熱𤉟𤎮𤑄𪌌𭵴𰞕𰞖
燮	夑爕㸉𣀢𣁧𤏻𤓖𪺂
犛	㹈𢿂𤚐𤚜𤛆𤛖𭯡𭷧
猎	猟獡獦獵𡗇𤡕𤡡𤢪
王	𠙻𠰶𡭤𢏝𤤇𥝍王⺩
班	般𤤻𤦦𤼬𪻮𫁤𰢀𰢁
琼	焭璚瓊瓗𢶇𤦱𪼌𬎘
瓞	𠀶𤔅𤫰𤫴𤫼𤬎𭤢𮐏
甚	𠥄𠯕𢍩𤯅𥱅𫞪𭭡𰢧
电	電𩂬𩂵𩃓𩃡𩃿𩅎𩅏
畋	佃田甸𢿊𤝗𤰖𤱞𭻁
疃	墥畽𤱝𤲫𤳿𤴋𤴎𭻕
疆	壃畕畺疅𡑆𤳾𫕘𭛌
疐	㚄𢷐𤴛𤴝𤴡𨂬𨆫𨇈
瘤	癅𥀓𥏵𦞧𦠝𰣲𰣾𰤆
皋	皐臯𦤗𬟰𬟲𭽗𮍞𰭌
盩	𥂎𥂕𥂱𥂲𥃁𥃍𥾲𧗑
眷	婘慻睠𠝂𡡀𨤓𨤗𮌐
睦	𡍬𡐑𡻲𬀻𬙩𬢃𬯦𰦉
砥	厎䂡𥐺𥑗𥒗𪿓𬒀𰦧
碗	埦椀盌鋺㼝𬒑𭾅𰤸
磨	摩䃺𢉳𢊠𣟖𥖤𨟖𰢘
移	乁迻䄬𢼏𥞀𥟻𰨢𰨨
稚	稺穉䄺䆈𥠧𥡖𥣔𥣦
稻	稲䵚𥝔𫁃𫂻𮇷𰨛𰨬
穗	穂穟繐𥛸𥝩𥣼𬔄𬟘
窑	窯窰䆙𡏟𡩴𥥲𥧟𥨭
窥	窺闚𡪽𥨖𥨾𨶳𩄾𮄚
竞	傹競竸𥪰𧫘𧫙𨐼𰩫
簪	兂撍簮𠒀𥯓𥴉𥸢𬖂
糈	稰𥚩𥹼𥺳𥺸𥻯𩝔𩰠
糒	𥺢𥼉𥼓𩜗𩝳𪌾𪍞糒
糯	稬穤粫糥𥢠𥻟𥻾𥼥
索	䌇索𡩡𢱢𣑇𥿟𥿿𦃦
纵	从縱𥾞𥾺𦂵𦄚𦆬𮈕
绒	毧絨羢㲨𣮩𣮪𣯏𰚮
绦	幍絛縚縧𠍞𦃡𩌜𮉎
缸	堈罁㼚𡨍𤬽𤭛𤭺𨠛
缺	缼𡙇𡚆𥁍𦈫𩫠𭆵𭑡
罏	𤮧𧆣𧆨𧆭𧇄𧇏𧈕𬙎
罕	䍐䍑𥤱𦉴𦉻𦋁𦋃𪞐
罝	𦊕𦊥𦊨𦊩𦋽𦋾𬙦𰭕
翅	翄翤翨䧴𢌟𦐊𩗍𭣗
翰	鶾𠣍𦒋𨌺𨍚𨎰𩙴𩙶
翱	翶翺𦒌𦒡𦒢𦤥𫅱𮊳
翻	拚畨繙飜𢑵𮇝𮋑𮋒
聃	耼𣅧𦕃𦕐𧵘𨈜𨈭𨉄
聒	𠅪𢡲𦕾𦗦𦗾𦘉𨈸𭥹
聩	聵䠿𦖥𦗿𦘃𦘄𦘋𮋿
聪	悤聡聦聰𦕻𦖟𦖻聰
胤	㣧𠃴𠉥𤗅𦙌𦙍𦞩𫃛
脆	椊脃脺膬𣈐𦙈𨉆𨊉
腭	卾齶㗁𦞐𦠍𪘰𪘽𮯋
臿	𠚏𢆍𦥛𦥫𦦈𦦘𬽋𰣜
舁	𠢈𢪓𢱲𢲓𦥠𦥹舁舁
舛	僢踳㚈㱛𣧒𣧘𰁒⾇
艰	囏艱𡅤𡅸𡆒𡿤𥌵𦫒
苟	芶𠷜𦯃𦯗𦰶𦲆𦴆𦴳
蒸	炡烝䒱𦲢𦲶𦻛𩚫𩟘
蓧	蓨𠤺𠤼𠥑𥁮𦰍𦰏𦺰
蔽	弊𢅷𦷥𦻾𦽗𦿔𦿝𫧉
薅	茠䒵𢫩𢬺𢴅𣐾𦵢𦼸
蘖	枿櫱㮆𡾹𢱂𣖂𣡌𧁈
虱	蝨𠤋𧈲𧋜𧌡𧍀𧒢𧓎
螯	𧏌𧑃𧒥𨄨𨅚𩪋𩪕𩪨
蠡	盠蟸䗍𢍝𥯵𧋠𧔑𧱤
蠵	𧓈𧓬𧓾𧔍𩺫𩽌𩽨𮕐
行	行𠎢𧗞𧗟𬠽𬠿𬽣⾏
袅	嫋嬝裊褭㜵䙚𡠿𧞡
裸	倮臝躶㒩裸𡑤𦣔𧝹
要	𠾅𡕯𡕹𡚩𡢗𦥺𦥼𰢲
规	椝規䂓𥚴𧠹𧠺𩑬𩓠
诉	愬訴𧦓𧦡𧩔𧩯𧪜𧫋
谩	謾㗄㗈䛲𠼦𠿐𧫩𧬒
豁	𡪞𧯆𧯉𫴓𭟙𮙐𰍢𰶖
豪	儫𠢕𢑸𩫎𩫒𩫕𩫚𩫞
豫	忬𠄛𠄝𢄮𪜱𫮻𮃯𰕑
豳	邠㟗𠚚𡺳𫴠𫿫𬋝𮠓
贷	貣貸𠌗𠍎𠏞𣃐𧴮𧴰
贸	貿𦕕𧴵𧵍𧵚𧵲𧶝𧶻
赓	賡𢉼𢊷𢊹𢋍𢋫𧵹𧷫
赘	贅𤺅𧷌𧸆𧸞𧸟𫎜𰷗
起	𡆡𢀽𢁈𧺫𨑓𨑔𨑖起
趼	𣀸𥀹𦢈𦢣𨇿𭽹𭽻趼
跻	躋䠁𢁃𤼥𧾙𨂋𨹷𨼻
蹙	踿顣䠓䠞𠏔𠑯𣢰𨈄
辅	俌輔䩉𣏤𥙳𨊽𩒺𭺼
辉	灳煇輝𠒽𠓊𤐕𪏕𰫃
辖	舝轄鎋𢮟𤛉𨍤𩏓𮝘
辙	勶轍𣪟𨅊𨏁𨏣𰹭𰹹
违	違𢯷𢾁𢾝𣪡𨔻𨕸𮞒
迴	回廻絗逥䢗𢌞𨕂𮞉
退	𢓇𢓴𢔕𨑧𨓆𨓤𨔫𩄮
送	䢠𠌡𨓵𨔮𨕩𨕪𨕼𫤮
递	逓遆遞𨓠𨔄𨔛𨕑𮞏
醯	䤈𨡂𨡇𨢘𨣓𨤅𩱗𬪲
野	埜壄鐢㙒𡌛𡐨𡑀𤝉
鏦	𥍷𥎋𥎒𥎙𨥎𨦱𨪯𫓩
铡	鍘䥷𠝝𨥼𨮰𨰉𮣔𮣬
铧	釪釫鋘鏵㭉𣏼𨫽㭉
铲	剷鏟𠚿𥊓𨩱𨪑𨲨𩮲
铸	鑄𤎧𨥇𨮚𨮩𨮾𮢷𮣑
镇	填鉁鎭鎮𨥵𨦸𨨋𰾂
镌	鋑鎸鐫䥴𨬺𨭽𨷫𩀟
閦	𨳖𨴖𨴟𨴠𨴧𨴨𨴳𬮥
闩	閂𢩠𢲙𢹞𣟴𣠯𣠸𫸁
阄	鬮䦰䰗𨵜𨷍𨷟𨷺𩰘
阔	濶闊䦚䦢𤄃𨴿𨶐𨶖
阕	闋𨴊𨶋𨶏𨶔𨶕𨶫𨷂
降	夅䧏降𡲛𡲣𨹓𮥃𰙳
限	㡾䦘䧋𣐻𨵬𨹎𨹨𱀦
隤	墤䫋𨓾𨘿𨽟𨽠𬯎𱀴
雍	邕雝𨿄𨿟𬆳𬐷𬽜𱁈
雕	彫琱錭鵰㓮𨿺𩀜𪄄
雹	䨌䨔𩂁𩄉𩅒𩅟𩆗𩇌
霆	𨖝𨗒𨗠𩄫𩆆𪪲𫑄𮦥
霣	䆬䨶𥧅𩆹𩇂𫕥霣𱁟
靡	爢𠞧𠠣𢌁𩞁𪎕𪎙𬏿
面	靣麵𠚑𡇢𣅍𨉥𫩑⾯
革	愅諽韚䪂𠦶𩎎𮧓⾰
鞭	鞕𠓠𠓥𤓋𩋹𩌻𫢛𫾦
饎	𩛉𩜂𩜮𩝮𩞡𩟄𬴺𱄆
饔	𩝹𩞠𩟀𩟷𬐧𬲖𬲟𮩕
饥	飢饑𠍃𩚎𩚐𩚑𩚮𩜆
饪	飪餁㶵䏕䭃𤇲𤏼𦜙
馘	聝𢧷𩉕𩠲𭍷𮡂𰼍𱄍
骥	蘎驥𧁳𩥉𩦸𭿮𱄮𱅌
髀	肶䏶䠋䯗𩩙𩩚𩪅𩪖
鬓	髩鬂鬢𨲺𩬆𩯫𩯭𮫓
鸓	䴎𤴒𧕫𩁜𪆼𪈦𪉀𱊳
鹂	鸝𪁐𪅆𪅌𪇺𪇾𪈳𪈹
麵	糆麪麫麺𧼸𪎎𫗖𬹃
黧	䵩𪑢𪑤𪒁𪒅𪒚𪒨𪒺
鼖	䩿𡒡𢿠𥀢𪔫𪔵𮮪鼖
齏	齑𠬘𦦏𧅠𧏝𩐐𩐓𪔉
齒	歯齿𣦋𦥒𦥪⻭⻮⿒
齧	𩖁𪘂𪘖𪘙𪙓𪙠𫜩𱌟
龀	齓齔𢎕𪗕𪗗𪗠𪗥𮮾
𠱫	㖕㖖𠰜𠱪𠲗𠲩𥩭𥩮
㼱	𠬫𠭝𡕶𡰺𤕱𤭀𥀅𥧐𩏈
䨴	𩄮𩅆𩅥𩅫𩅲𩆰𪒶𫜛𱁒
世	丗卋殜㔺𠀍𠦔𬃯𬆑𬔛
亥	㐪𠀅𠅆𠦇𢁓𢁳𬺷𬽆𬽇
享	亯𠅠𠅷𠆀𦎫𦕺𦴒𩫗𬝇
低	仾𠇓𠉃𠍪𢘢𫢏𰂂𰂄𰱠
侯	矦㑨𠨶𤧝𥎦𫢑𫶬𬾃𬾗
信	伩孞訫㐰䚱䛨𡥪𫺑𬢭
傳	伝传𪫖𫝊𬨼𬨽𬩒𬩘𰺿
僰	𠍷𠒧𠒹𢣡𢣱𣕾𤏡𭶚𰒝
养	飬養䄅䍩𠐒𡂺𢼝𢽁𮨽
冤	寃𠕤𡈒𡨚𢱽𢲀𥦱冤寃
凛	凜澟癛癝𠘅𠘐𠘟𡬜𪷤
凤	鳯鳳鴌䲶𠤈𢐴𧱶𪆍𮭟
刀	刂釖𠚣𪠤𪥂𫥰⺈⺉⼑
刚	剛㓻𠇙𠇝𠜛𠝴𠝾𡬺𮟱
剑	剱劍劎劒劔釰鐱𠝏𠠆
卓	龺㔬𠤚𠤞𠤟𠦝𢂚𢂦𫭬
卿	𠨍𠨞𡖖𡖥𨜊卿卿卿𨜮
厄	戹阨𠂘𠂬𠨗𠨳𢀴𢨤𢨩
叠	曡畳疂疊㬪𣆹𣈍𤴁𰣖
哲	啠喆嚞埑悊𠺤𡕇𫎘𬔭
唐	啺𡃯𣉺𥏬𪪒𫑲𬋺唐𰇺
啬	嗇𠎸𠹫𠻮𠾂𢡉𤲝𭍠𰉒
啮	噛嚙囓齧𠲼𠼜𪘅𭌰𱌠
嗣	孠𠻸𢩚𫲱𫸙𬔟𬔠𬴴𭻢
嘴	咀觜㭰𠹮𠾋𠿘𡁫𡂗𭉨
块	凷圦塊墤㙕𠙽𠚛𡉇𡒽
垠	圻泿㙬𡊷𡋳𡏴𡑃𡹊𤍂
墉	牅䧡𤰎𩫏𩫱𫨠𫨣𬙸𬴘
壑	㕡𡎙𡐍𡓛𡓼𡔗𡺻𧮸𫮺
壞	坏壊𢸬𢽫𣀤𣀩𣩹𣩻𦦶
处	處䖏𠁅𠙚𧆵𧇤𩂜𩂫𩂭
奥	奧隩𠆑𡪃𡪿𥨩𫤭𫯱𮤦
好	㝀𡚽𡥃𡥅𡥆𢑒𤫧𩐔𰠗
始	乨兘㛎𠃭𠙉𡜗𫩞𭒉𰀼
家	宊𠖔𡧚𡩀𡩅𡩙𡩚𡩵𰍀
容	㝐㣑𠕺𠴅𡧶𡨐𫩣𰍢𰶐
寒	㥶𡫙𡫜𡫮𡫾𣽬𪧑𪧔𰌳
射	䠶𡬤𢎤𨈡𨉅𨉛𪿎𫒱𬫸
尝	嘗嚐甞𡮢𨡔𨣛𭇐𭺮𰀶
尪	尢尣尩尫㒬𡯁𡯂𡯪𡯭
岛	島嶋嶌嶹隝隯㠀𡷊𡻅
巽	巺顨㢲𢁅𢁉𢁌𢌴𢍳巽
席	蓆鿮𠩌𠩛𢎹𥔆𥱊𪪌𫨂
干	乾幹榦漧𢧀𤮽𤴲𰒩⼲
幼	糼糿㓜𠣎𢆲𢆵𢈗𫲪𫶹
庄	庒荘莊㽵𠗎𤕶𤖄𤖈𦻊
应	応應譍𠩍𡄖𢈀𤻮𧭭𭌃
庵	盦菴葊蓭𠪎𡩯𢊊𤲅𮅫
弦	絃㢺𢎺𢏛𢏸𢐁𢐐𣃡𥾏
强	強彁彊犟𢏟𣚦𪪺𰐓𰐘
彻	徹澈𢕹𢕿𢖉𢾿𦔞𨅊𭜈
徙	𡕝𡲴𢊚𢓊𨑭𨔀𨖤𨗬𰺵
恐	㤟𢖶𢘠𢙢𢙷𢝭𢟃𢟈𭜦
悖	勃愂誖㪍𡥏𢘩𢚦𢟥𢠜
憩	愒憇𡲽𡳅𢠾𦧗𦧯𦧰𮍺
懒	嬾孄孏懶㦨𢤿𢛔懶𰑐
懦	儒愞懧耎䎠𠏢𢘎𢘧𢡼
我	㦱𠨂𢦐𢦓𢦖𢦠𢦴𨈟𩇶
戚	傶慼慽鏚𠋰𠎰𡫁𢦫𢧯
所	㪽𠩄𢨷𢩇𦕄𫝂𫠦𬻐𬻔
抵	底拞掋牴觝𠥯𠨿𢪔𰓀
掘	撅欮㙭𢬝𢴺𢶵𣔭𭠜𰓓
掴	摑𢐚𢧷𢮎𢰢𢹖𢼛𧤯𰓳
插	扱挿揷𢭉𢭡𢭣𢰔𭡝𮃘
摇	揺搖摿㨱𢭊𢭌𢳘𢳸𢵾
支	搘枝𠦙𡽒𢺶𣏃𫠭𰆰⽀
收	収敊㧃𠬧𤱜𦀏𭣖𭣣𰠦
教	敎𡥉𢺽𢻍𢼂𢼅𢼬𧧿𪵋
斥	㡿𠨺𠩋𡱞𢇛𤵍𫷫𫾯𭙕
旌	旍㫌𣃠𣃢𣄀𦑊𦑖𦲵𧚫
无	亡無㷻𠘩𠘻𣄯𭴾𭴿⽆
显	顯㫫㬎䧮𩔐𩔰𩕃𩕛𬱉
暖	煖煗㬉𢝶𣆝𣊵𤆱𤌢𤏙
本	夲楍㮺𡗧𡴡𡴩𣖎𫧨𬬊
栗	慄㮚㯨栗𡨓𣗴𣡷𣡼𬃄
桑	桒槡𠭌𠭚𠭨𣏏𣕐𰇃𰗑
榛	樼獉蓁㰉𣓀𣘘𣝾𦽥𦿒
樵	櫵藮𢸺𣛑𣟶𦿕𧄡𬋈𮒝
欢	孉懽歓歡讙驩𩿊𭞹𭭕
殿	壂𡱒𣪍𣪪𣪫𣪵𫵕𭮺𮝿
氓	垊甿萌䇇𣱅𤱕𦫋𭯰𭷋
水	氵氺𡱊𡿭𣸕𤆙⺡⺢⽔
法	佱峜灋㳒𢌇𣳴𣶽𫼒𰝄
泽	滜澤睪㚖𣼦𤀎𤽈𨼸𬈃
涉	拾渉㴇𣥩𣥿𣶵𣻣𪵺𰛌
渔	漁䰻䱷䲣𣿡𤀯𩵎𩼪𫙐
游	遊㳺𠾈𣸯𨓓𭂗𰛶𰠘𰨊
源	厵㴟𠫐𠫒𡇋𧪒𨻣𬈛𰆬
溯	泝溸遡㴑𣴔𣵐𣷥𣹫𭳏
滋	兹孖稵滋𣳯𤀮𤂇𬇿滋
滕	𣎌𣹸𣽨𤑘𦂙𦞃𪱪𬛍𬟀
烈	列烮煭烈𤈘𤉩𤋴𤍅𤎁
烨	墷燁爗璍㒯㷸𤍞𤑼𤒃
犀	屖𡥷𡱝𡳚𤚌𫵠𭕝犀𰠨
犁	犂䵓𤛺𤛼𤛿𥝫𨩂𫀭𭷥
率	卛䢦率率𠅋𧗿𭅩𰳪𰳭
珉	玟琘琝瑉碈䂥䃉𤤍𰦱
珍	珎鉁錱𤤽𧟪𨨖𨫎𭹀𰡳
瑙	𢜍𤤼𤦏𥒢𥒤𥓱𥖋𰡻𰢐
瑟	㻎𡘼𡚉𢊎𢜈𤊇𤨝𩇰𰑴
瑱	琠瑱𤤦𤦹𤩱𦔿𦗁𭹃瑱
甘	㤌𠂀𠙸𠙿𤮺𤮽𤯀𩚵⽢
甜	咁甛䑚䣶𥑠𦧩𩚣𪌩𭥹
畏	𠂽𤰣𤰰𤰲𤰵𤱖𤱫𪽉𰢼
畚	奙𠫻𡘊𡘞𡙂𡙲𣓩𤲙𤲛
皇	𤽙𤽚𤽢𤽧𦤃𦤍𦤐𫭠𰡸
盈	溋盁𡺡𥁀𦀚𫞯𫞰𰀬𰤴
盗	盜𠉭𠩼𠪁𤋆𤑂𥶎𨹇𨹒
省	渻眚䁞省𠥇𡞞𡮀𥄾𨵥
看	㸔𡈟𡰶𥉏𨌁𬋭𭾩𰥜𰹑
确	塙確碻礭㱋𥔳𥔼𥔿𮦻
碾	榐𥑊𥔤𥗇𥗷𨋁𨋚𪿟𰦪
社	䄕社𡉹𣒮𣴳𥙭𥙲𥝟𰨃
祗	祬𣱊𤲥𥘡𥘢𥙂𥙆𥙠𥙥
秽	濊穢薉𢧹𢧼𤻀𦿧𬓩𮃊
穷	窮竆䠻𠤂𡩫𥧺𥨃𥨪𨉺
突	堗宊突𠫓𡦾𥤮𥥛𥥜𭓧
窃	竊𢿑𥧼𥨛𥨱𥨷𥨸𥩈𥩓
窍	竅䆻𥤾𥥆𥦂𥨂𥨃𥨄𰩝
竖	竪豎㑠㒘䜿䝂𠐊𥪛𥪡
算	祘笇筭𢌺𥫫𥮅𦭌𮅕𰩯
篪	竾筂箎䶵𥬌𥰽𪛌𪛍𪛔
糖	糃糛醣餹饄糖𥼽𥽻𰪩
糜	穈靡䭩𥽼𩞇𩱸𪎖𪎭𮂦
纂	篹繤𥴌𥴠𥵺𦆈𮅾𮆭𮆷
缶	缻𤭟𦈢𦈪𫒘𬼈𬼉𭎘⽸
美	媄媺嬍羙㜫𡠾𡵂𫟈𰌁
聖	圣𣈂𨲚𨲢𨲣𨲿𪣿𰿒𰿓
聚	𣷗𦖏𦼈𧅞𧚿𨈦𨛿𫮣𬥁
肄	𢄥𢑩𥏚𦘗𦘞𧲁𨽹𨽽𫆔
胁	愶脅脇脋㤼䏩䏮𦚰𮌯
臭	殠臰臭𣧁𤢳𤽨𦤀𦤁𫜤
节	兯卩卪節㔾𠐉𢎛𥴝𭅲
芻	刍蒭𠣧𦭍𦮊𦱪𦱻𦷝𰰪
范	笵範𣔶𦬳𦴮𧁉𭐃𭹬𰰰
草	屮艸艹騲𢂉𦯨𦳕𦷣𰏒
蔑	薎衊𤊾𤻻𦸑𦹋𫈦𫈼𬝏
蕤	苼㽔𤯹𤯼𤯾𦷃𦼆𦿮蕤
虔	䖍𠧘𠧺𠧾𡨊𦴋𧆛𪪐𮓚
虺	螝𠙍𤳳𧈤𧍥𩗝𭕎𭺟𮓸
衮	緷袞䙛𧙰𧟏𧟗𪜣𫋴𬡄
裔	𠆘𧘉𧘊𧘯𧚞𧛨𧛲𧜟𫨝
西	卥㢴𠓦𠧜𠧧𣓨⻃⻄⾑
视	眂眎眡視𤋇𥄙𥄚𥅔𥅭
诋	呧詆𠱎𠱱𠳉𧥮𧦒𧦺𫪭
豕	𡰯𢁓𢒓𢒔𧰧𧰬𫨂豕⾗
豸	𤜚𤞌𤞝𦎋𧋈𧳃𪺏𭸜⾘
赧	䩅𢟻𢠱𧹜𧹞𧹠𩈑𩈫𩈶
蹯	籵𣫯𥸨𥻫𨁢𨅴𨆌𨆜𩕈
轰	揈轟𨊷𨋌𨌼𨌽𨎇𨎗𰹋
轾	輊䡹𦥎𨍀𨎌𨎐𨎘𨏅𨏑
辑	楫輯集𨌖𨍣𨍾𨎵𭋷𮝛
迟	赿迡遟遲邌𠌬𢕌𨒈𨖔
迹	硛跡蹟䟱𨒏𨒪𨖊𫐨𬅼
遗	遺𧸃𧸯𧸽𨖽𨗔𨗭𨗮𨘤
郭	墎廓𨞥𨟍𨽏𩫏𩫩𬃬𮠄
钵	盋砵缽鉢𡀖𥁅𥁈𨩃𰤶
闹	閙鬧𠅈𠆴𠇰𡗚𢂂𨳪𨶂
阜	峊阝𠻰𠼛𨸏𭚖⻕⻖⾩
陈	敶軙迧陳𢽬𨊴𨸬𨻰𨼤
隔	𤗦𨻛𨼣𨼥𫕆𫕕𭕰𮥯𱀹
雏	雛鶵𤕂𨿉𨿊𩿮𩿿𪀫𪄞
霰	䨘䨷𩃂𩃝𩄧𩅤𩆥𩆵𫕣
霸	覇魄䩗䩻𧈉𧟲𧟳𧟶𩄤
靈	灵霊靈𫕞𫲚𫻝𬋣𬰑𬻼
飞	厾蜚飛飝𠃧𢑮𦐭𦒮⻜
餍	饜𤞣𤹍𤻩𤼛𩞚𩞹𩩶𩪴
饫	秗飫饇𩚿𩜈𩜏𩜢𬁷𮠝
饷	銄餉饟䊑𥹝𩜋𩝾𩞃𩞥
魁	𣁽𩲅𩲔𩲙𩳭𫣅𫿶𰁩𱆗
麸	稃麩麬麱䴸𤿲𨦶𪌐𪌻
默	嘿墨穆黙㱄𥂮𪐥𪐩𰴪
鼠	鼡䑕𠏙𠝈𣆎𣆨𤔆𦥩⿏
齊	斉齐𬁼𬩣𬹱𮮺𮮻𮮼⿑
𡊄	𠬁𡊯𡍊𡏙𡏰𡓴𢍨𣀰𣀲
𤮪	𤮡𤮤𦨆𦴌𦶨𧜈𧝢𧝻𧞚
𦌔	䠣𦋠𦋭𦌮𦌻𦍅𨂳𨃿𫅈
你	伱伲儞妳𠉎𠑓𢘞𤙌𬽿你
倦	劵勌惓𠉅𠉮𠌍𠡶𢛗𤷄𰮤
兕	𠒃𠒅𠒊𠙃𤉡𧣶𧤄𧰽𧱃𰄒
军	軍𠖉𠣞𠣦𡗺𡗽𡨏𦉼𰏃𰕲
制	剬製𠛐𠛯𠜔𠜿𠝁𠝦𭃥𭃭
剥	剝礡𠚩𠚬𠛧𠝌𠧓𨭂𭃄𰄜
卯	夘戼𤕰𦕔𩇦𩇧𩇨𫑗𭄠𭅵
原	厡邍𠩠𠩤𠪥𠪰𨘡𨙅𰆖𰋎
呼	乎嘑歑謼𠰗𡀛𢧶𣣍𣣕𧦝
咽	嚥㖶䑍咽𠰸𠲛𠽥𠾰𡲙𦝪
响	響㗽𡨇𡪆𡪥𥀾𥖡𧬰𩐢𩐿
唇	脣㖘䫃𠵧𠸸𠼉𣲼𦟢𩕁𬫷
嗀	㱿嗀𠹢𡔮𣪛𣪥𣪳𪡹𫯁𭮪
四	亖龱𠁤𠃢𦉭𦉵𰆅𰉐⺫⺲
多	夛𠀰𡏗𡖇𡖈𡖩𢑑𢑰𬻈多
娄	婁𡇔𡇭𡜰𡝤𡝨𡞔𡡋𡡼𦭯
子	㜽𠙭𡿹𢀇𢀈𢀉𣕓𰱤𰲀⼦
宁	寍寕寗寧甯㝉㝕𡧃𡧾𰍠
宜	冝宐㝖𠖃𠣨𡧧𡨆𡪀𡪏𡬐
寻	尋㝷𠎅𠙛𡬰𡬶𡬻𡼢𢍟𢒫
封	㞷𡉘𡉚𡊋𡊽𡎈𪢽𫡗𬏆𰉨
尊	𡬭𡬯𡭆𢍜𥈪𫂫𬟌𭔿𰃝𱀵
尬	魀𠆷𠙤𡯓𡯔𡯕𡯗𡯰𡯽𭺝
就	𠅮𡯶𡰔𡰗𡰜𫎢𫢁𭕐𭕒𰻜
尹	𢁨𢂟𢂫𢂬𢂭𢃁𢃂𢃵𢃹𪱛
尿	溺㞙㳮尿𡱤𡱴𡲘𣭼𣻨𰎂
履	履𡲟𡳐𡳷𢔃𨂠𨇐𩕎𰙺𱂛
岳	嶽𡴳𡵤𡵹𡵽𡶓𡶠𡶳𡷒𡽺
帮	幇幚幫鞤㨍㿶䩷𢸌𩋮𫑢
廉	亷槏㢘廉𠔳𠪊𢉧𢋯𤎉𤯍
延	㥐𠭐𨒂𨕇𪫘𫹔𬠿𭚕𰀵𰺴
开	幵開𨳟𨴂𨴆𨴉𨵑𨵹𨶘𨶷
弹	弾彈𢎚𢎝𢎟𢎩𢎫𢎬𢎲𰐔
当	儅噹當𡭠𢑐𨼴𬻬𭻂当𰣈
徒	𠫠𠫮𢓂𢔗𣥲𧺑𧺔𨑒𨑡𬾉
微	嶶㣲𠌝𢕄𢕧𢼸𣁋𦘇𧗬𭗒
徽	幑㫎䘗𡽪𢾰𧗼𪫕𪫜𫶛𬜃
忧	怮憂㤑㥑𠪍𠮕𢙥𢝊𨗫𩕂
思	恖𠂺𠃼𡴓𢆿𢍄𢙥𢙦𥥁𰐽
悉	怸𢗣𢗦𢘤𢘳𢘻𢙍𢚊𢝕𭜧
惰	媠憜㤢𢞑𢡢𢢠𢣖𢣝𰒇𱀋
愍	惽慜㥸𢚓𢚢𢞰𪬒𫺮𭮬𰑭
戒	悈𢌵𢦥𢦬𢦶𪥅𫳉𫻨𰂽𰒧
战	戦戰颤𡃣𢦮𢦯𢧐𣥎𣥟𣥭
戮	僇剹戮𠞨𡠢𡭁𣩍𦐟𦐱𦞋
执	執秇𠌷𡘺𡙕𢦕𢩾𤞷𥝡𰺥
搜	廋捜摉蒐搜𢅢𢯱𢱻𢴼𢯱
摩	擵攠𢣾𢳀𥗂𥗘𦇑𪎚𭢮摩
攀	㐴𠔀𠬜𡴂𢌬𢸅𣗚𣝴𫽷𬅍
攘	壤襄𢭗𢺖𣀮𣤸𣤽𥀶𭢯𭤑
攲	敧欹㩻㿲𢽽𤿡𤿯𥀴𨜅𰕂
敕	勅勑㩽𠡁𠡅𢽈𢽟𭣴𰅍𰖫
春	旾萅㫩𣆊𣇸𣈤𣊨𦸬𰋠𰥖
智	知𢜔𣉻𤾞𥏄𥏼𥏾𰖨𰤛𰦙
服	𠬝𠬨𠬩𠬮𣍞𦨈𦨋𦨕𦩟𨈞
柩	匛匶柾𠥂𠥬𣡛𫡹𭍸𰒿𰧴
柳	栁桞桺橮柳𣒘𣓠𪲺𬂪𭡧
树	侸尌樹𠊪𡬾𢒳𣑣𣗳𧯴𨅒
梅	坆栂楳槑梅𣏁𣐥𣒫𤯏梅
梦	夢夣㒱㝱𡪎𦴋𦻸𦿛𧁌夢
棘	㯤𢄬𣗥𣘐𣡍𨋵𪲸𫂧𰘥𰙉
楚	椘檚䠂𣕑𣕪𣗂𣗢𤻇𧯴𪲡
正	靕㱏𠙺𠤭𢘫𣥆𣥔𤴓𧾸𫠱
深	冞罙㴱𣵫𥥍𥹄𪜅𭰹𰜞𰜿
煞	𤋣𤋥𤍁𤍹𥋧𪹉𬊹𭣦𭣰𭶍
燕	觾鷰㷼䴏𠙯𢇈𪈏𪸍𬪀𱈪
爱	愛㤅𢖻𢙴𢛭𢜤𢟪𬋪𭐫𭞦
牵	摼撁牽𢫀𢴡𤙺𪺮𬌟𭷣𭻈
玺	壐璽鈢鉨鉩𡊒𤨐𤫆𨮪𩂊
瓢	㼼𤕉𤬟𤬡𤬢𤬣𥢝𬓘𭶶𰢡
申	𠭙𠭜𢑚𣇗𤕌𤰶𤱓𦥔𦦀𫐃
界	堺戒畍𠇎𠷟𡧅𢌯𣌥𨻞𭻃
瘠	脨膌㾊𢊌𢋐𤹠𤻣𥕂𰂕𰣰
盟	𢄾𥁰𥂗𧖸𧖽𪭓𰤺𰤼𰤾𰥀
盥	泴𣹉𤃗𥁉𥂞𮍮𮍱𰤷𰤿𰥇
真	眞𠤛𡙊𫞲眞真真𰅴𰶱𰶵
神	䰠神𤕊𥙍𥚞𥛃𥛠𥜩𫋵𰕡
称	偁爯稱穪趁𤔹𥟋𬓴𮃎𰨋
窈	𡢵𡢹𡣠𡣡𥥎𥦖𫳀𰩆𰩉𱁓
篾	䈼𥯣𥰓𥱗𥱡𥱢𥴸𫂔𬕪𬕭
簠	盙㝬𠤱𠤳𠥟𦻌𧁔𫧚𬔮𮆊
糟	蹧醩𥽾𦵩𨠷𨣹𨤇𨤈𫢞𮇘
纛	翢𢃶𣫟𦇨𦐩𦑢𦒇𦒛𦒞𦒯
织	綕織𥿗𥿮𦀂𦀗𦁋𦁓𦃎𦄩
缁	淄緇䊷𥾒𦁃𦃠𦄛𮈨𮈻緇
罂	甇甖罃罌𤫡𤭫𦉍𦉦𧶹𮉺
罐	欟礶罆鑵𤮳𤮴𮉷𮉸𮉹𰭃
置	寘𢍧𣇣𦋘𦋲𦌃𦌖𦌤𧴴𰭋
耕	畊𠛝𣏨𣚣𥝷𦓮𬏄𰅑𰢹𰼗
耜	梩㭒䎣𣏌𣙼𤹇𥞐𦓨𦓵𮋧
联	聨聫聮聯䏈𦕱𦖹𦘈𬚙𬚛
聘	𦕊𦕮𦖄𦖙𦖛𦖳𨉂𨉯𨊀𮜷
肃	粛肅𢙻𦘛𦘜𦘝𦘡𬎾𮌄𮌆
肇	肈𢾹𦘟𦘥𦘦𪭛𫼉𬑷𬚫𬢅
肉	宍月𠕎𠕜𡧢𥤬𥥀𮌇⺼⾁
育	毓粥袬鬻𡔴𣫺𦝑𩛭𮌫育
胡	鬍㝬𠴱𡋞𣬣𣬧𩑶𫧚𫯤𬰒
胯	舿趶跨骻𡱼𦚄𦚬𦜮𰮟𱅯
脐	臍䐡𠬐𦙟𦜝𦜢𦠃𪗇𪗌𰯉
膝	厀𢑧𣍿𦜔𦟇𦡀𦡩𮌒𰆓𰯌
艳	艶艷豓豔𡤩𡤸𦫢𧰚𧰟𫇤
艺	兿埶秇萟蓺藝㙯𡎐𥡩𮒛
花	化华芲蘤𤆇𤾡𤾸𧅅𫇹花
蓑	簑簔𠱗𡔤𦸏𦻫𫈮𫈶𬕁𰱪
蕊	惢橤繠蕋蘂蘃𣛚𥳝𧄜𮐟
藻	薻𦸼𧀉𧁑𧃡𧄩𧅂𮆼𮐪𮒌
蚊	蚉螡蟁䘇𧉬𧊈𧏎𧓢𧓹𧖁
蚌	硥蚄蛖蜯䖫䰷𧉳𧉻𧎞𩷙
蜂	蠭䗦䗬𧉳𧊩𧊵𧋴𧒒𧓶𫋠
蜜	𠖧𠖪𡩓𥧧𦸞𧉴𧒧𧓫𧖅𮔉
衄	衂䏔䘐䶊𦤊𧖩𧖷𧗗𪖔𮕝
衰	𠆂𠆏𠆚𠌺𣩖𤸬𧜸𮕩𮕱𰱪
褰	攐骞䙭𧛓𧝱𧞼𧟑𬋸𬧎𰴊
襄	勷㐮𠆝𡣿𧞂𧞜𧞻𫬯𬩿𮖠
襻	袢鑻䙪𥘽𥜳𧘋𧘒𧘙𧘬𧘵
观	覌観觀𥍊𥷯𥸑𧢉𧢪𮗚𰴔
觉	斍覐覺𡕚𧠔𧠭𧠳𧠷𮗓𮗜
觿	觹觽鑴𧣽𧤢𧤤𧤪𧥁𧥅𧥏
謇	㔓𠹟𠽱𡄓𡅶𧪤𧬯𧮈𧮎𫷔
貌	皃貎㒵㹸䫉𧳒𧳓𧳖𨉍𨓅
走	赱㞫𡗱𣥕𣥚𧺆𨑿𨒨𫯛⾛
达	迏迖達㒓𨔂𨔬𨔶𨖫𨘝𫐳
道	噵衜衟辺𠐵𡬹𨔞𨕥𨖁𨗓
遥	姚遙䢣𨓧𨓳𨔚𨔠𨖈𨗽𬨶
金	钅金𠈘𠉓𠊍𨤾𨥀𨥄⻐⾦
锅	煱鈛鍋𡪝𢧘𩰫𩰬𩰭𩰮𱆋
長	镸长𠇬𨱗𨱘𬔡𭀟⻑⻒⾧
阱	坓汫汬穽㘫𠁲𠭗𠭘𠭢𨸥
隘	塧𨻹𨽈𨽝𨽩𨽪𨽴𰄔𱁃𱁄
雉	垁搱鴙鶨𥏷𨿘𨿝𪁰𪅊𬑳
韬	弢轁鞱韜𨌨𩊹𩏋𩏍𮧲𰹙
颠	傎厧顛㒹𠑘𠖩𠫉𡬅𤠶𱂪
飙	颷飆飇飈飊𩖚𩖡𩖧𩗈𩗹
饙	𩚰𩝀𩝂𩝼𩞑𩞳𩞴𩟲𫯉𱄀
首	𡭨𥃻𥅷𦣻𦤅𩖐𩠐𩠶⻡⾸
髓	膸髄䯝𦢪𩩜𩪄𩪏𩪦𩪷𰯟
鲻	鯔𩞒𩞓𩞮𩸛𩺅𩻂𩻨𫚁𬵇
鷇	𣪸𣫠𩀠𩏻𪅏𪆉𪇀𪇄𬆮𮭛
鹤	寉靍靎靏鶮鶴䳽𩿖𪇦𫛏
鹯	鸇𩁉𪃋𪄃𪄐𪄟𪄡𪇥𪇮𮭙
黾	黽𠖆𦊣𦋍𪓑𪓖𪓙𪓝黾⻪
鼗	鞀鞉㲈𡣐𩊲𩌿𩎣𪔛𮧤𮮨
㲲	氎𣮨𣯉𣰭𣰸𣱃𤴍𧟕𬇇𭯦𭯯
事	亊仕叓𠁱𠫺𠭆𠭏𤔇𪜃𭄡𰛿
亲	媇寴親𡩁𡪔𢈥𢾉𧠍𧠸𧡘𭮸
会	屶屷會㑹㞧㣛𠃐𠍗𡥋𣥈𪩚
俊	儁隽㑓㑺𠊂𠋍𠍑𨶊𬽴𮥸𰂍
劳	僗労勞憥𠣁𣬃𣬄𣬇𤛮劳𰞪
升	斘昇阩陞𢦑𦫵𧿘𨁠𫝢𫝣𬹦
和	咊惒訸鉌龢㕿𠰓𠲆𤧗𥝸𪱳
囟	顖龱䏤䪿𠙷𠚁𦞤𦥓𩒦𩔨𩕄
妖	祅訞䄏𡝩𩲓𪥲𫰋𭙖𮫜𰋼𰴁
寅	㝙𡓓𡓵𡨒𡩟𡩪𢁐𥦕𦦚𫴃𱁗
寡	𠆣𡩼𡪍𡫌𡫛𧵿𪞕𪟊𫳜𰍏𰥡
尔	尒尓爾而𠇍𠑂𢀪𣙡𣱹𦹚𭁲
屎	宩矢𡱁𡲑𡲔𡲖𢈍𢨻𥻐𦳊𮏗
岩	壧嵒嵓巌巖巗碞礹𠼧𡾏𫶝
岷	崏渂㞶㟩㟭𡶗𡶘𡸧𡹋𡼐𣊽
岸	垾堓屵㟁𠦖𡎑𡵃𪣄𫶂𭎋𭖎
崩	垉𡶤𡷌𡹌𡹔𡼜𢉁𨹹𨻱𭖚𱀙
帆	忛颿㠶䑺䬚䭵𤖫𩗋𫶿𰏖𱃁
年	秊䄭年𠃇𠡦𠦅𠦚𠫺𠬋𦼌𰨝
廩	𢊸𥠌𪜥𪯜𫂵𫃅𫡿𫳖𫿝𫿣𰁿
弁	覍㝸𠭛𡭪𢍍𢍘𢍙𥿋𭚞𰆮𰕇
弥	彌瀰镾㣆㫆𢏏𢐳𢐶𢑀𪫁𭚫
捷	掶疌㨗㨩𢱅𢳿𢵂𢶝𫉏𭱉𰙪
攫	爴玃㩴㸕𡈅𤔗𤔩𭍲𭣶𭺙𰠃
敢	𠭖𢧎𢼿𢽤𢽿𣆸𣪏𣪓𪠬𪵎𰕊
斗	鈄鬥鬭㪷𠥼𠦁𣁬𣂑𤣫𬺵⽃
旅	捛祣旅𢬜𢰈𣃨𣄆𣥏𣥐𧙿𭡖
日	囸𡆠𡆸𡇁𡇗𡈎𣅱𬬊⺜⽇⽈
明	朙眀𠒫𠘨𣇱𣎁𣷠𫥂𬚽𭧌𰤺
昏	惛昬𣄼𣄾𣆾𣇲𣉈𣋯𦟲𰖘𰘕
星	〇曐皨㽮𠻖𣅨𤯢𤽛𤾪𭥕𰣀
朕	𢀹𣍹𥆭𥆵𦨶𦩎𦩗𨈽𬚷𰮤𰰍
杯	柸桮棓盃㮎𠤯𠥀𠥧𦈧𦈶𮅁
枭	梟鴵鷍䲷𣐩𤡔𩾒𩾓𩾣𩿋𱈝
标	墂幖摽標檦㯹𢰳𢲗𣗖𣠙𣠪
梁	樑鿄梁𣑱𣹷𥹦𪲠𫿼𬂾𭩮𮌹
次	𠕞𠤣𠤫𣄭𣬌𦮏𫠨𫡜𬅹次𰰽
歹	歺䚟歹𠔅𠔆𠧔𡰤𡰮𣦵𣦶⽍
毁	毀燬譭㩓䃣䛼𡒂𢾌𣪷𣫏𪑺
氂	㲠𣭭𣮋𣮖𣯕𣯛𣯷𭕲𰚥𰚨𰚰
煏	㷶𤌈𤏛𤏹𤐧𤐸𤓜𤓞𥣇𥻅𭶚
熏	焄煇燻爋窨薰醺𡴦𡽽𤋱𤓂
熟	孰𡒒𡦦𤋩𤍨𤏅𤒆𤒒𦏧𪹱𰞊
熬	敖熝䵅𤎅𤏺𩱏𪌑𪌠𪍮𪍾𭵶
燖	燅爓𤍙𤎢𤏝𤑩𤑶𦠹𪹻𬊈𰟚
狒	𢀏𤝟𤲳𥜿𥝃𥝈𥝊𦦔𦦷𪒵𮂮
猿	猨蝯𤝌𤟗𤠔𧳭𧳷𪻅𫞤𤠔𰡜
瓶	甁硑缾䍈𤬮𤭅𦉇𪋋𪾘𬙌𰚗
瘦	痩膄𤶟𤶯𤷺𤸃𤹶𤺁𤻺𦢝𰮾
登	豋蹬𡖚𢍪𤼪𤼶𤼷𤼼𧰐𰤐𰶝
矢	笶𠂕𠓡𡗛𥎨𥬘𥬟𰃖𰃞𰦒⽮
礼	禮礼𠃞𤔑𥘆𥜨𥜪𥝏𧰖𮕤𰳰
祈	祈𣂘𣄨𬀍𬀟𬁩𬣃𮁪𰒃𰕣𰕥
窟	堀窋𡑣𡻋𢷈𥦙𥧊𥧋𩨳𫁗𰍅
築	筑簗𥭰𥯹𥰺𥲒𥲓𥲔𥴁𥵭築
簋	朹㔲㔳𠥗𣌽𣪕𣪘𥁬𦹧𭾁𮅐
粗	蔍觕麁麄麤𡔙𥼗𥼡𪋙𪋨𮭲
糊	餬䉿䊀𥹽𩰯𩱍𩱒𪍒𪏳𪏻𪐉
纠	丩勼糺糾𠃖𠃚𠛩𠝙𢀙𢒥𥾆
绝	撧絶㔃㔢𠤉𢇍𢱺𢴭𨼎𫃠𮅅
羌	猐羗𠒌𡬎𡸓𡹽𡺛𦍎𦍑𬙬𮊦
羚	麢䴫羚𦏪𦏰𪋓𪋚𪋦𪋪𪋳𪋶
腾	駦騰驣䠮𠗲𦫀𩥱𩦜𩧔𩧖𱄴
茧	絸繭蠒𥭥𦆐𦇂𦻷𧁥𧅇𧅶𮑿
葉	叶枼葉𦯧𦯲𦰧𦶫𦹁𫟒𮑃𰱒
蚤	䖣䗢𠙬𤼭𧈠𧈡𧈹𧎇𧎮𧒮𫊫
衔	咁啣嗛衘銜㘅䶢𠷢𠼫𠾑𬡀
表	檦錶𧘝𧘦𧘰𧜫𧞧𧞯𧞱𪊘𪊬
袜	帓襪韈韎韤𤿗𥀯𥘯𥿉𫀇𮧬
覃	𧟩𧟹𧟻𪉙𪉞𪉫𪉲𪉷𫟛𮗂𮗆
角	捔觮龣𤰄𧢲𬺠𭃘𭺸𰴟⻆⾓
赣	灨贑贛㶥𣹟𥫔𥽇𧹄𧹉𩑅𰷝
越	䟠𦈭𧻂𧻪𨒋𩁹𪌝𫑛𬦌𰙦𰙯
跨	夸㐄𡕒𧿋𧿾𨀗𨁣𨂍𨅯𰸉𰸝
辔	轡㘘䩛𢢦𢥩𣦱𦆕𦇷𨏯𨏷𮝲
遁	踲遯𠎻𢝺𨆛𨔡𨔵𨖡𨘭𨘹𨙆
遊	游逰䢊䢟𢰧𨒣𨒰𨓎𨓗𨔼𫹛
邻	厸鄰阾隣𠳵𨞁𨞧𨼺𨽃𪌛𱀨
重	緟𡍴𡍺𡒀𡔅𡔌𦌋𨤣𫟯𬥥𰋟
錽	鋄鎫䥑𡕢𨥧𨧴𨩵𨪘𨬄𫓸𮢂
铁	銕鐡鐵䥫𨦘𨫓𨬿𨮯𮢜𮢾𮢿
阳	昜氜阦陽𥌖𨹈𨼗𨼘𨼡𬀑𱀲
雨	㲾𠕒𠕘𠕲𡷎𩁼𩗿𮦄𮦆⻗⾬
韦	韋𡙝𡚈𥀊𥐄𥐅𦲐𮧮𮧯𮧰⻙
饕	叨飸䬢䬭𧈐𩚓𩜻𩝕𩝵𩞂𩞣
髯	髥䫇𣬭𣱄𨱱𩑞𩑺𩒹𩓾𩓿𩬥
鬻	俼粖㣃𧷏𧸇𩱌𩱙𬑂𮌿𮫚𱆐
鱼	魚䁩𤉯𤋳𩥭𩺰𮫬𮫭𮫮𮫯⻥
鳏	矜鰥鱞䚪𣎕𥎅𧤩𩶊𩹌𩻲𩻴
鸱	殦鴟鵄䲭𨾦𨾽𩿍𩿒𩿨𪂑𱈧
鹌	鵪鶕䨄䳺𩀂𪁟𪂻𪃬𪈍𮥽𱁎
鼻	𢋛𢍂𦤓𮮰𮮱𮮲𮮳𮮴𮮵鼻⿐
丘	丠坵邱龷㐀㘳𠀈𠀉𠀌𠤢𡊣𤤘
丧	喪䘮𠷔𠷫𠸶𡂤𡚏𡴧𦦦𧚾𬽐𭈬
乘	乗椉𠅞𠅟𠓲𠓸𠓽𠨇𣒧𨝄𪞳𬽌
伞	仐傘繖𠋔𠌂𠍘𠎃𡙫𢄻𦇕𰂝𰃯
冒	冐㒻㫯𠕙𠕚𠕬𡇾𡈌𡈘𧠊𫭒冒
农	欁農辳䢉𡺒𢖢𣊤𣎭𦦤𦦥𨑋𭆒
冬	昸鼕㫡𠔙𠘀𠘗𡕙𡘬𣅈𣆼冬𰖋
劙	剓剺蠫㓯𠞙𠞤𠠂𠠍𠠞𠠫𧏇𭃤
勤	廑懃懄勤𠏏𠢀𠢄𠢇𤐂𦹝勤𰅉
卷	巻弮捲縳㢧𠨟𡗪𡰳𢀻𨤖𩁫𭅑
听	聴聼聽𠯸𦔽𦕘𦕢𦖆𦗟𦘏𪢧𭇓
嚚	𠽺𠾅𠿦𡁬𡂨𡅚𡓶𡓿𪹬𭌪𰊩𰊪
坐	㘴㘸𠱯𡉡𡊂𡊎𡋏𡋐𡋑𡋲𪠶𰉗
壹	壱夁弌𡔹𡔾𡕄𡕋𡕌𡕍𡘵𢍾𫯁
备	俻偹備僃㑲𠃰𠈍𤖤𤰇𤰈𦯞𬾨
寧	宁寜寧寧𡨬𡨴𡪕𡫇𪫳𫝱𬐘寧
峻	俊埈陖𡋴𡍵𡹀𡺲𡼕𡿀𮥘𰎯𰎴
庶	庻遮𠩽𠪌𠪛𠪜𠪤𢉍𢉙𤈲庶𰆨
廛	壥鄽㕓㙻㢆䣑𠪨𡏂𢋨𫮈𭚌𮤪
恶	僫噁悪惡䛩𡌥𢙣𢝏𢝴𭞋𭞪𰂢
整	愸𠢦𠢫𢝗𢿄𢿋𢿫𣦔𣦤𭄺𭣼𰋞
晋	晉㬐㬜𡥨𡦌𣈆𣋤𣋧𣌇𦗎晉𰦣
望	往朢望𢾘𣍢𥩿𥪛𦣠𪤀𬲤𭱗望
松	庺枀枩柗梥鬆㮤𣘏𣙚𥝶𰗷𱆳
泉	洤湶灥㟫𡺙𣹻𤱄𤲴𤽄𤽇𭥚𰤔
泥	坭埿泥𡊴𡌰𥩥𭂊𭎐𭰖𭰬𰊌𰊒
满	滿𠐎𡈝𡈪𣼛𦿭𩞘𫉗𫞜𭱪𰛷𰜾
煮	煑䰞煮煮𢐼𣎧𤆯𤌄𤑨𦒽𩱰𪸦
燧	煫鐆鐩隧㸂䥙𢷊𤑾𤒮𤓫𨽵𰟹
爽	𠁊𠎛𠙠𠷹𡘖𡙁𤕡𤕤𫎿𬦟𭑘𰋜
留	畄畱㽞留𤱊𤱚𤲢𪽋𫶌𬎿𰢴𰣃
盐	圤鹽䀋𥂭𨣎𪉟𪉩𪉹𭏛𭱦𮩒𮭭
盘	柈槃洀盤磐鎜𡘃𣔚𥂏𥂟𪾊𮆮
瞢	矒𥉞𥊃𥊄𥌋𦱛𦴁𦴔𦴲𪾿𭿃𰦄
短	𢭃𥎭𥎶𥎷𥏆𥏸𧯟𧯣𭔰𰦓𰶘𰶚
稷	畟禝𥞷𥟄𥟛𥠎𥠰𥡂𥣊𰧷𰨄𰨭
究	䆒𡫄𥤯𥤳𥦄𥦵𥧖𥨇𥨓𥨶𫿪𰩞
笑	咲芖㗛𠸍𠺑𥬇𦬫𭉋𭊔𰩬𰩶𰩾
罽	㓹𣯅𦆡𦇧𦋋𦋴𦋺𦌓𦌗𦌞𮊐𮊛
肯	肎肻𠕔𡧓𣍟𣥤𦊈𦘫𦙎𦙡𦚋𣍟
胸	匈胷𦙄𦙞𦚍𦚾𦛄𮌚𮖣𰮌𰮎𰮨
腕	捥掔䯛𢪸𢫪𢮗𢮘𢯲𥆶𦙵𦛥𦞿
舜	䑞𡐩𡐼𡳈𡳉𤔠𤔤𦨀𦲋𰂧𰉿𰰊
蒙	冡懞濛矇靀䝉𠐁𣉭𫎇𬑔𰭒𰰡
虡	簴𣚛𣝛𥲤𧆾𧇀𧇆𧇽𨮗𨯼𮅽𮆔
蚕	蝅蠶蠺䗝䗞䘉𧉂𧉏𧌩𧑯𧕽𧖟
褒	孚裦襃闁𠆅𧚱𧛙𧛱𧜪𧜯𧝾𬡭
辟	闢𠈳𠊕𠊸𠮃𦜺𨐓𨐝𨐨𨐴𪿢𮝻
辩	辡辯䛒𠷊𦌽𧦪𧦬𧩵𧪔𧮀𮗿𰁏
长	仧兏長𠑷𠑻𠑿𠔊𠙁𠤐𡕣𦁢⻓
闻	聞䎹䎽𥹢𦔴𦔵𦕁𦕌𦖞𦖫𪖴𫔝
陆	踛陸𠃈𡽷𤱒𨸪𨽐𨽫𨽰𨽱𩣱𪽘
陵	夌琌䧙陵𠡭𤦫𨹧𨺶𨻎𨻪𱀘𱀬
隙	郤隟䧍𡭴𡭽𡮂𧯈𧯊𨻈𨻩𨻶𬯍
零	〇泠苓霗霝零𡈍𩂙𩃞𩆖𩆼𮖿
鞴	鞁𩊶𩌎𩍁𩍘𩎬𩏦𫖉𭬽𮣆𮧟𮧫
飕	颼颾䬒𩗆𩗣𩘌𩘖𩘠𩘦𱃈𱃉𱃌
驱	敺駈驅䡱䮃𣦑𨒡𩢧𩢩𩣕𩤀𬳩
魑	螭䄜䬜𩗨𩘉𩱹𩲵𩲶𩳀𩳦𩳩𩴭
鲊	鮓鲝䱹𩸑𩺃𩺆𩻢𩼮𩼻𩽟𩽫𮓖
鸨	鳵鴇䳈䳰䴐𨾐𨾑𨾙𪀀𪁣𪁬𪃁
麽	么嚒尛庅懡麼䶸𠄮𡭚𡭯𡮡𤹳
齿	齒𠔒𠚄𠚒𠚕𡵩𡽔𣥫𣦗𦦂𮮽⻮
严	嚴嵓𡃫𡅔𡅝𡅮𡅴𡅾𡆉𧠀𫿞𭤏𭴪
丽	婯麗䴡𠀙𠀞𠐚𠧥𡡜𪋘𮭶𮭷丽𰀕
乃	廼迺𠄎𠄕𠚝𠧟𠧤𠧱𢉓𢎗𢎧𢏩𬼎
佛	仏仸彿髴𠇛𠏹𠑵𢿀𣀪𦤲𫢋𰁰𰂣
克	刻剋尅𠅏𠅔𠅡𠑽𠧳𠧹𠧻𡱀𡱠𣳂
吃	喫噄㰟𠯏𠯡𠰆𠹙𠿊𡁒𡄊𨋻𰹕𰹘
吻	呅呡肳脗㖧㗃䐇𠞍𠳪𦝮𪠴𬛆𰮱
善	譱𠲘𠵊𠾄𠾺𦎍𦏟𦏯𧮟𮒹善善𰑼
嗟	䦈𠺜𧨁𧪘𧪰𧫯𧬑𨲠𨲻𬢚𭉈𭊋𭋿
囊	嚢𡃟𡄜𡄿𢑿𣡏𣡦𧆔𧛦𬺿𭋛𭌌𰀉
垂	埀𠂹𠃀𠄒𠣔𡍮𡷩𡸁𡹁𢛲𬽍𭏞𮉰
塍	堘塖畻𡏕𣎒𤳁𤳔𤳮𦩱𧑥𭐂𰊓𰊷
壶	壺𡆵𡍐𡐎𡔥𡔦𡔲𡔳𢑹𥁖𬻫𭈰𰚈
天	兲靔䒶𠀑𠀘𠀡𠑺𠕹𠘲𦴞𩇗𩇞𬻃
契	偰栔禼㓞契𠛉𡬨𢍆𢍠𣓇𣔘𭃌𭚘
媵	賸㑞𠈖𠈪𠈫𠊶𠑇𡟒𦩩𫲀𫲂𬁨媵
孕	佨㚺㞌𠈤𡢘𡥗𡱟𣎜𥀨𥀩𨈼𰂫𰅮
宇	穻㙑㝢㡰𠨯𡧈𢉠𣳿𫭎𬇢𬐞𬙗𡧈
宾	賓賔𡧍𡧼𡪛𡫅𤍘𥥃𥦎𥧨𧶉𧶎𭓫
寝	寑寖寢㝲𠖗𡨞𡨦𡩠𡪢𡪷𡫒𡬓𥨊
岁	亗嵗歲歳㞸㱑𡶣𡹖𡻕𡻷𢧁𦴹𭭚
巷	衖闂㟟䢽䣈𢕵𨙵𨛜𨜕𨞔𨞠𬩺𰻰
往	徃徍迬𢓯𢓸𢔎𣶂𧗧𨓒𨓹𪴸𫭠𭰵
怨	惌㤪㥐𠈢𠨛𢖭𢘈𢘔𢘖𢛪𭜥𭜨𰮗
悟	寤忢旿晤𠵥𠼘𢛤𢤓𥄪𦤜𬤿𭜐𰮧
慎	愼昚眘㥲慎𡴜𡸱𦚉𫷊慎𰑝𰕡𰥎
敦	㪟𠧈𠧉𢼪𣀦𤭞𤮩𫓕𫓜𫿠𬙸𭣸𭣾
敲	摮毃㪣䯨𢻤𢿣𢿲𣫁𩫈𪯪𫾣𮪹𱅺
旨	恉指㫑㫖𠤔𠩊𠮛𡱔𣅀𣅌𣥜𤮻𭥍
晔	曄曅曗皣𣊪𣋌𣋓𤾧𤾴𤾹𤾼𭧮𰤝
氍	㲒㲘𣭂𣮔𣯑𣯒𣯸𣰋𣰠𣰧𣰰𣰻𣰽
济	泲濟㴉𣳵𣸓𣸫𣺃𣺴𣽱𣾯𤀮𦪱𰜮
疑	𠤑𠤕𠤗𠤘𠤜𥎲𥏑𦬦𩉏𪵊𭼃𰅢𰡀
疾	𠥻𤕬𤕺𤕼𤖏𤶅𤶥𥏂𥏦𥏴𥐃𨕾𰠕
皮	𠬱𠰎𡰻𣪉𤿌𤿤𥬖𪾇𰆿𰤪𰩷𱂁⽪
盏	榐琖盞醆𤐒𥁘𥁫𥰎𥱔𥵃𦈻𧣴𨫀
眉	睂𠃜𠪃𣅩𣮮𥅉𥅕𥅮𥇮𨉭𫳜𬚳𭕘
矿	丱磺礦鋛鑛𥐫𥒩𥔾𨥑𨥥𨨭𪿨𮀑
硇	碙䃩𠬦𣲿𥐼𥑚𥑨𥑩𥑪𥒚𥓁𥗰𥗸
糁	籸糂糝糣䊏𥹪𥹾𥻕𥼾𩜱𩞀𮇿糣
罩	箌羄䈇䍜𠕭𠟅𥵢𥵤𦋇𦋐𦋚𦋜𭓶
羹	焿羮𡙡𢑌𦎟𦢋𦢹𦣍𩱋𮊰𮊱𮫛𱆓
肆	銉䦉𢑨𦘨𨽸𩬶𩭞𪱫𫬫𫺟𫿔𬁯𬯓
脉	眽脈衇䘑𦚡𧖴𧖹𧠧𧵾𩈗𪵵𬇾𬐔
臧	匨𠗱𡒉𡒤𡒥𢨑𤖔𦣣𪺞𫻶𮍏𮍐𮍒
舐	咶狧舓䑛𦧇𦧓𦧧𦧪𦧫𪙬𪙶𭇇𮍵
茕	惸焭煢瞏㒌㷀䒯𠊫𠌻𠎽𠙦𡞦𡦃
萬	万㸘𠃡𢁭𤈬𤍚𥝄𥝅𫈧𫉨𫊅𫮮𰊶
蠹	螙蠧𡕎𥑟𥗤𧉓𧋌𧎆𧓜𧔬𧔵𧖌𮕛
载	傤縡載𠁘𠟭𠧋𡔬𡕀𡙚𤱱𨊦𨌏𩖘
辞	辝辤辭𤔧𤔲𦧦𨐕𨐲𨾱𫍗辞𰰈𰺬
辰	䢈辰𠂮𠨱𠨷𠩐𠩟𨑃𨑄𫝕𭆃𮝾⾠
醢	𥂠𥂧𥂹𧅽𧆗𨡝𨡿𨢗𫗘𬐵𬐺𰥉𰼐
隆	嶐隆𠾐𤯲𨹠𨹿𨺓𨺚𨺛𨺼𨻦𨼇𭰸
青	寈靑𡗡𡴏𡴐𡴑𡴙𡷉𤯝𤯞𰀈⻘⾭
韛	㰆韛𢴾𣠻𣡖𩋂𩎻𩏃𩏄𩏕𪖞𫖔𮧳
颖	穎颕㯋𣣅𣪑𥛤𥢙𩒠𩓙𩓵𮨍𰦠𰨔
食	饣𠊊𠋑𢻘𨢁𩚀𩚁𩚃⻝⻞⻟⻠⾷
香	稥麘㿝䅨𣌡𥞈𥞌𩠼𩡄𩡢𪏰𪏽⾹
鬘	䯶𨲛𨲩𨲾𩦧𩭀𩭈𩮉𩮒𩮺𫙃𮫇𮫉
鵴	𨿥𪀣𪁁𪅞𪇙𪇢𪈅𪈓𪈢𪈣𮭀𮭝𱊇
麟	麐麟𥛷𪊓𪊙𪊭𪊱𪊲𪊺𪋲𪋷𫜏𮓯
保	𠈃𠊻𠌀𠍂𠍙𠤏𠦀𡥀𣎼𤔍𤞥𭫄𰐯𰠀
关	閞関闗關𠴨𢺄𨳡𨳨𨳹𨴊𨵿𨶚𨷀𮤚
冥	㝠㫥䆩𠕾𠖇𡨋𡨕𡨶𣩆𥦴𭁶𭁷𭥵𰭐
创	刅刱剏剙創𠛂𠛲𠝀𠝵𠞴𠟐𨱠𬾺𭃅
华	崋華蕐䔢𠫫𡼀𡼙𡾀𣓚𦮴𦰗𦶎𦻏𬝨
厥	𠪆𠪏𠪼𣅞𣅲𨈐𨈑𬇌𭆇𭆏𰆡𰆢𰆣𰆩
启	唘啓啔啟諬闙𠭎𠶳𠶶𠷠𢻻𢼄𥔩𧘗
喜	垚憘憙歖㐂𠶮𠺇𡔯𢐭𢝫𦬅𪮬𬺽𰋉
堆	垖塠㕍㢈䜃𠂤𠦗𡌙𡸄𡸠𡸬𡻛𣳨𰍄
堕	墮墯陊隋隓𡐏𡐦𡓉𡓗𥪹𨼢𨼰𫝡𭎽
塞	揌㥶㩙塞𡔂𡨄𡩿𡫟𡫩𡫳𡫼𡺶𥤧𦦍
墙	垪墻廧牆𡒅𡒜𡓜𢉈𢋢𤖠𤖣𤖧𤗼𰊃
寇	冦宼窛㓂𡨥𢽉𥦆𥦲𭁵𭒊𰍂𰍈𰍕𰍙
弄	挊挵㢅㺯弄𠧗𠮽𡀜𡱯𢌮𫇥𭘃𰐇𰡶
復	复復𠋩𠣴𠣸𠣾𠤇𡕴𢕒𢕛𢕶𣸪𰋏𰻇
惠	僡恵㥣恵𠀄𠅤𢞨𢞯𢠞𢡘𢥁𤈂𦣽𦻇
散	㪔㪚𢻎𢻞𢻦𢻾𢿨𢿱𢿷𢿺𣀙𣫄𣮠𭣹
期	朞稘㫷𠔸𡢁𣅆𣇳𣍠𣍡𣍣𣔔𦝁𬢝𰢪
死	𠑾𠒁𢀸𣥴𣦸𣦹𣦾𣧇𤯽𦫺𦭀𭭾𭮀𭮁
焰	焔熖燄爓㷔𤌵𤏭𤑑𤒦𤒰𦥿𦦨𪹗𰞬
爨	熶㸑𠆡𡚣𤍾𤏷𤑇𤑖𤒐𤓟𤓥𫴘𬋡爨
發	发彂発𢽔𤼦𤼲𤼵𭛁𭣺𰤎𰤑𰱋𰱎𰱜
矛	鉾𢦧𢦵𢧟𥍤𥍥𥎠𨥨𨦜𭿵𭿶𰦎𰦏⽭
福	茀福𤔜𪧥𫳠𫴅𫴗𫴩𬒴𮂊𮂔福𰨎𰴃
稳	桽穏穩㒚㝧𡘫𡨠𤯗𥡷𥦊𥧚𨆲𮂹𮇮
稽	乩䭫𥞞𥟵𥠻𥡞𥡳𥡴𩠥𩠦𩠨𮃛𮃢𰨮
耽	眈聃躭䤁𠖙𤯉𦕍𧴸𨈔𨈠𨈦𨊍𨊗𫆁
臺	台坮㙜㙵䑓𡋛𡌫𡌬𡎲𡐉𡔼𦤼𦥄𰙱
荒	巟荒𠃤𠯚𥞙𥠸𥡃𥡍𦮋𦱐𫟎𭅟𮎰𰨧
菹	葅𥂯𦯓𦳎𦵔𦼬𦿘𧀽𧂚𧄗𧗎𧗘𬝿𮏢
豆	梪荳䇺𠅉𣅋𣅑𣅣𤽋𤽔𧯚𧯜𧯝𧯣⾖
辜	孤㱠𡱨𡲞𢩍𢪿𢻄𤿛𦍬𧬕𨐞𨑀𫧡𫪔
逸	佚劮泆逸逸𠡓𤖍𤖚𧼧𨓜𪫐𫐶𫺜𬌍
邦	邫䢶𡶚𤰔𤰫𤱵𨚚𨚜𨚦𨛁𨛝𨛟𬪛𮟵
雁	鳫鳱鴈𤻉𩾝𩾦𩾸𩿫𪁡𪂢𪜤𪠐𪠕𱈩
风	凬凮檒風飌𠂡𠘴𠙄𠙈𠙊𠙗𩙐𩙣⻛
饮	淾飲㱃𠿮𣤗𣲎𣵂𣶗𨠅𨡢𨡳𩚕𩚜𰙘
鬲	镉㽁䥶䰛䰜𡑾𨬑𩰲𩱇𩱔𮣙𮫙𱆎⿀
鬼	𢇼𢝾𢧩𣆠𤱲𩲚𩲞𩲡𩳉𩳹𩴿𪭎⻤⿁
鶒	鷘䳵𤄄𪀦𪀸𪃠𪄠𪄪𪅍𪅙𪆟𪆵𫛶𬈆
龜	亀龟龜龜龜𤕣𪚦𪚧𪛉𬺞⻱⻲⻳⿔
乾	乹亁干𠃵𠄃𠄊𠄋𣦖𤌹𨺩𪟴𭅓𭑙𰋮𰕬
参	參叄叅曑葠蓡蔘薓㕘𠫭𠫰𠫵𠻝𣊖𭆤
叫	呌嘂嘄噭訆譥䚯䶷𠮧𠮪𠶼𠸵𠻌𭇴叫
吝	恡悋㖁吝𠫤𠯌𠯛𠲲𠳈𠳺𠳻𠴽𢙵𫢧𰂊
嚏	嚔奃㖒㗣䶍䶑𠲣𡁲𡄶𪖣𪖮𪖰𭉶𭋄𮮹
堇	菫蓳䒺𡎸𡏳𡐳𦰩𦸧𦸨𦹆𦻋𦻍𨤬𭎙蓳
奏	㔿𠂑𠭕𠭡𡘶𡙹𡲯𡲱𡳡𡴝𡴨𢽥𫝤𫾾𰎈
奔	犇逩奔𠬼𡗲𢍃𣦴𥝯𧾜𧾭𧿣𨁼𨃦𩣺𩦥
孽	孼巕蠥㜸𡦣𡦯𡾤𦽆𦽚𦾦𦾨𧃯𫲕𫲲𰲓
德	徳恴悳惪㤫㥀㥁𢛳𢜖𢠀𢤊𨗌𨗤𪬥𫣜
施	䙾𠆹𠇜𠤒𢒃𢻩𢻫𢻱𢼉𢼊𢼘𣁒𦭇𭤸𰶿
枣	栆棗𠐇𠖼𠗀𡗭𢄀𣝯𥸮𦰈𪲥𭪀𭫝𰆂𰘚
款	欵歀㱁𢡜𣢸𣢾𣣇𣣗𣣙𣤂𤘯𫎉𫩀𬅭𰙒
流	㳅流流𡵅𡵰𣱳𣳛𣴑𣹭𣹳𣻤𪶷𭰈流𰝆
皱	皺𢑫𤷨𤿥𤿮𤿿𥀙𩈟𩊥𩋓𭽪𭽲𰤠𰤤𰤮
直	直𠅺𠤽𡇛𣓟𣖇𣖈𣖴𥄂𥠤𬽈直𰅰𰥐𰥑
穀	糓谷㝅㯏穀𣫋𣫗𥝻𥞤𥡛𬂈𬤵𭯁穀𰨴
窗	囱牎牕窓窻䆫𠂨𢘯𤗄𤗉𥥬𥦗𥦾𰍋𰩍
葬	塟㘸𢍈𦱬𦱼𦲳𦴓𦴱𦵏𦸟𦽱𦿑𧂥𬋿𰉎
藏	匨蔵䒙𡍱𢧿𤖋𨤃𪴼𫇺𫟖𫳼𭗉𮐻𮐼𰷍
衡	𠧲𠧽𠧿𡘻𡙉𡙏𡧦𢔖𢖍𧗣𧗾𨏎𫜘𰆆𰆈
证	證䥌䥭𤪉𦷘𦹨𧁅𧁆𨧭𨨼𨨾𨪔𨬛𨭧𨭻
豚	豘㹠𠭣𠭿𢃻𢄉𤜨𤝄𦚌𧰭𧱔𧱮𧱯𨔡𰯓
釐	𠩺𡪂𨤭𨤲𨤳𨤺𪧳𬎕𬫁𭆆𭆉𮡟𮡠𰼚𰼛
隶	隷隸𣜩𥛬𥻊𨽻𨽾𨾀𨾁𫆕𭐘𮂄𮇬𮥴⾪
饱	飹飽䭋𨩭𩛁𩛊𩛒𩛞𩛴𩜕𩜿𩝒𩝓𩝩𩞛
鬥	斗閗鬦鬪鬬𧯞𨷖𩰑𩰒𩰖𩰚𩰛𬼍𮤟⾾
齐	亝斊齊䶒𠄷𠫸𠫼𡕓𦙟𪗄𫿭𬽒𰗄⻫⻬
亘	亙㮓𠀕𠀥𠄢𠄣𠄭𣍭𣕲𣘰𦚸𦚹𦵕𫧍𠄢𱅻
从	從䢨𠂥𠘬𠚪𢓅𢓺𣃗𣊷𧽵𨑢𨑹𨒀𨒁𬽡𰋣
仙	仚佡僊僲屳㒨𠇈𠎣𠏓𠏡𠑣𧫹𬿑𭕴𰂅𰩭
变	変變㜻㣐𠮓𢒛𢒟𢒦𢒪𢒭𢻝𣀵𦇥𫯌𭣛𭤛
坻	坁坘汦沶𡉬𡉳𡉶𡊆𡊇𡊈𡊓𡌟𡍓𣲋𣹡𤍫
密	宻䌏𡊭𡧸𡨑𡪖𡶇𢛬𤛬𪧅𪧝𪱭𫳡𭓽𰖗𰻺
归	歸㱕䢜𡚖𡹙𢅦𣦨𤾤𥇳𨓼𨺔𨺜𫨬𰂿𰯳𱀠
总	捴揔搃摠総緫縂總㹅𢝰𢭇𢵃𤙹𥡥𥾜𦀙
恼	悩惱憹㛴𡛛𡜣𡜪𡝲𡡟𡢆𡢋𢙉𢚰𤹻𪦅𰅷
拜	拝𡴬𢫶𢮠𢰛𢱭𢳎𢴽𢷎𢹄𣧙𣬊𣬓𨀪𨀲𭠠
斋	亝夈斎齋㪰䄢䬩𠫱𥚪𩛚𩱥𩱳𪗑𪗒𪗓𮋡
暴	曓虣㫧㬥暴𣉱𣊻𣋦𣋳𣋴𧇑𧇒𧇭𫻺𭧂𰣎
朗	朖朤誏㓪㫰朗朗𡦀𣊧𣊭𣍷𥇑𬁈朗𰐁𰰔
浸	寖濅㴆䆮𡩻𡫏𣷽𣹦𣹰𣺎𣼡𣽧𥧲𪫆𭷆浸
漆	桼㓒㯃𢒡𣑰𣴶𣶠𣶾𣷦𣷵𣸡𣸷𣾰𪶰𭂜𰛖
灶	竃竈䆴𤆧𥨈𥨠𥨫𥩋𪚨𪢾𫁘𫝰𬔇𬔓𮄅𮄍
無	无橆𡙻𣑨𣚨𣞣𣞤𣟒𣠮𤀢𤍍𫡟𬻜𬻝𰙄𰙈
畴	嚋疇㿧𠭵𠷎𠼡𠾉𢏚𢑔𢑜𤲮𤳠𤾊𤾦𭻪𰣚
箕	𠀠𠀮𠔋𠔛𠔝𠚙𠥊𠥩𠴩𠵶𠷛𡿸𢌰𥫚𥫶𦋊
粪	糞䆏𡊄𡐢𢷥𤲲𥹻𥻎𥻔𥻜𥻪𥻰𥼇𥼈𥽒𨤘
若	叒若𠭀𠭚𠰥𡧻𡻦𣞆𥉧𦱡𦱢𦱶𦴈𧁇若𰻩
边	邉邊𦍇𨑶𨓉𨓙𨕙𨖂𨘢𨘳𮞰𮞽𮞾𮟗𮟚𮟣
造	艁䒃𢽍𦹢𨑴𨒽𨕡𫓇𫳩𫸂𫻵𫿜𬥘𬩈𬪵𰍟
雷	畾靁㗊䨓雷𡈶𤳳𤳴𤴌𤴐𤴑𩂩𩄣𩇓𰣞𱁪
鬃	騌騣骔鬉䰌𣮤𤙷𥪗𨲃𨲇𩥷𩮀𩮪𩮰𩯣𬴪
亩	畂畆畒畝畞畮㽗𠭇𣢿𤰘𤰜𤰿𤱈𤱑𤱔𤲧𰢾
光	灮炗炚炛烡㫕㶢𠈑𤈛𤉭𤎫𤐥𤑋𰝼𰟎𰭧𰰬
圣	琞聖𠄵𡉄𡑺𤦉𤦨𤪈𥅶𦔻𦕡𦣨𧟿𨉑𩫽𫆅𭹖
奁	匲匳奩檶籢籨𡙗𡚍𢅸𢊴𣜰𣫢𨕏𨘰𪛒𰻉𰻒
彝	彛彜彞𢁔𢇏𢍵𢑱𢑴𤔳𤕃𦄳𦆩𦇚𧤋𫸹𫹈𰐥
断	斷㫁𠜷𠝅𠡱𢆸𣂢𣂣𣂱𣂸𣂾𣃔𣦕𣦙𰕠𰕤𰻋
涩	歮歰澀澁濇瀒𡉔𣴀𣴻𣹣𣾫𣿠𤁍𭭩𰙜𰜀𰜲
燎	尞爎爒㶫燎𡼷𤉞𤉲𤊽𤋓𤋯𤎚𤐗𤑗𤒧𰝶𰟤
画	畫畵粛画𠚇𡇍𡱮𤌲𤰱𤱪𤲯𤲿𥂛𦘕𦘚𨽶𰢵
羁	羇羈覉覊䩭𦋱𦌭𦌯𦌰𦌱𦌹𦍈𦍊𧠄𩆺𮄤𮗌
耄	旄眊㿞𠅸𠺛𣭢𣮳𦒷𦓄𦹾𦽡𦿗𧂕𩲘𬴖𬴗𭓮
颐	頉頤頥顊㶊䨨𦣞𩑪𩒫𩔦𩔿𩠛𩠝𩠞𩠡𩠢𮨈
龟	龜𠁴𠃾𡪫𧑴𪚴𪚺𪚾𪚿𬹝𮯛𮯜𮯝𮯞𮯟⻳⿔
兜	兠㨮㿡𠅭𠒟𠙓𠙡𠙧𤾆𤾇𦆘𦋌𦙒𨩁𪝿𫥡𫥢𰃎
凿	鑿䥣𣪲𣫞𣫩𣫫𦦹𨖐𨗩𨧔𨯳𨰒𨰢𪗛𪚆𫠙𮣡𰚊
厚	垕㫗𠩒𠩞𠩰𠪀𠪋𡎋𡦩𡦬𢈲𢛥𣆉𣆪𫝗𰆝𰑱𰴷
商	謪𠘾𠹧𠼬𠾃𠿧𡂦𡃬𡄚𡅟𥫐𧶜𧷞𧷮𨝗𨶼𬔩𰇟
夏	夓𠀼𠌘𠍺𡔰𡕭𡕻𡕾𡖃𣋗𤴞𨂮𩖳𭼂𰣠𰣡𰲭𱂙
夔	蘷虁䕫𡕸𡕿𡖂𣀚𣦞𦾪𦿵𧁎𧃍𩠮𩠰𬟡𭤍𮒆䕫
寿	壽夀𠋮𠷎𡔺𡔽𡭏𤕋𦓂𦓃𦓆𪜙𪤳𫡰𭉠𭐖𭐙寿
得	淂㝵㝶䙷䙸𠊚𠭁𢔨𢔶𢔽𧴫𫣓𬁟𬙕𮙮𮙱𰆸𰶸
斫	剢斮斱斲斵㓸䂨𣂡𣂪𣃀𣃂𣃃𣃆𣃋𣃏𥖛𦘣𰕢
秋	秌穐鞦龝䆋𤇫𥘙𥝚𥝛𥡄𥡌𥣨𥤚𥤛𥤠𪔁𪚼𪛁
脑	匘垴腦𠜶𠟞𡍗𦛁𦛳𦜩𦝗𦝶𦞄𦠊𦠤𦭣𩩀𮌗𰯝
虐	瘧䖈䖋䨋𣑅𣑾𤼻𥤫𧆝𧆧𧆩𧆱𩁿𫊝𫊞𮓘虐𰀂
鬣	鬛㲱䝓𣰫𨲲𩮊𩮓𩮮𩮻𩯓𩯝𩯡𩯻𩰆𩰇𮤅𮫈𮫋
黎	菞鿯㴝黎𥟖𥟦𥠖𥡓𥡚𥢀𨝟𪏯𪏱𪏵𬓪𭱮𰙬𱋵
初	䃼䥚𠁉𠜆𠫎𡔈𢀯𢀰𣦂𥘉𥘋𥘨𥝢𫢈𭃡𮕥𰀔𰀛𰨛
叟	傁叜𠊗𠋢𠌞𠌟𠪇𠬲𡨎𡨙𡨝𡨨𡨼𪠨𫨈𫨏𭆪𮍧叟
涎	湺㳄㳭㵪𠿢𣳧𣵤𣵿𣶙𣶚𣶛𣶜𣷜𣹺𣼞𨺘𮥋𰜅𱀌
睫	䀹𣭶𣮌𣮍𣮑𣮒𣮣𣯥𣯮𣯰𣰍𣰞𥇒𥇾𥈤𥊆𥊩𰚭𰦆
睿	叡壡㪫㲊䜭𠮉𣥸𣦒𣦳𥅵𥇨𥈠𧇋𧇖𧇗𧇩𧇪𧷁𫳤
穆	𢾓𢿉𢿬𥟙𥟟𥠇𥠘𥡆𥡊𥡋𥡻𥢣𫀾𫁇𫖜𬓽𰕓𰘟𰨲
虎	乕俿虝𠨼𠪳𢁺𢋪𧆞𧆢𧇂𪊖𪋕𪑷𭅯𭅰𭆄𮓙𮓜⻁
鞠	毩毱踘陱䪕𠣮𠤄𠮑𡖁𣮓𣮕𣮥𣮴𣯲𥷥𩊸𩌽𩍔𩍸
髮	发髪㛲䯰䰋𡞝𤕥𤠁𨱳𩑛𩑱𩠕𩠖𩠙𩬃𩬇𩬉𩬊𩬕
鬱	欎郁鬰㭗𣟜𣠈𣠫𣠵𣡜𣡡𣡨𣡱𣡸𦉠𦉤𩏴𩰩𬅕𮫘
鼎	鐤鼑㫀䁀𣂨𣂰𣃊𣃒𣇄𣇎𣇓𣈈𤖎𥅀𥇴𧇷𪔂𫓊⿍
齑	虀韲齏䪠䪡䪢䪣𤅈𧅴𧆌𩐆𩐇𩐈𩐊𩐋𩐎𩐑𩐒𩐊
地	坔埅埊墬嶳的𠋞𠏂𡍑𡏇𡑸𡒰𡒴𡒿𡓬𤅴𤯓𧹵𨻐𪒉
愆	諐㥶䇂𠌤𠍴𠎝𠏘𠐨𠐷𢕆𢙡𢝐𢡊𧗭𧗺𨐋𨓲𪬓𫺛𰻑
终	夂崇終𠂂𠔾𢍐𢒣𣈩𣉉𣊂𣊜𣧩𤯚𤽘𤽟𤽫𤽬𦄖𦤒𪚪
举	擧舉㪯𠃥𠔖𠦮𡕖𡥳𡴃𢍁𢍑𣁄𤼳𤼴𥸦𦥑𦦙𦬇𦬠𪴿𰓉
寂	漃諔𠱙𠴫𡧘𡧤𡧯𡨁𡨜𡪌𢚍𥤲𥤽𥥒𥥘𥨅𧧌𰈎𰩊𰩒𰴳
弼	佛弻拂㢶㢸𠡂𠨒𢏇𢏺𢐀𢐈𢐑𢐜𢐝𢐡𢐤𢘍𢼥𨋥𨚍𬩂
灾	災烖甾菑𡿧𢎇𣏹𤆄𤆋𤆎𤆲𤈮𤉣𥘔𨉇𨓌𭴠災𤉣甾𰞟
照	曌炤燳㷖𢡰𢢤𣉬𣊕𣊧𤈌𤉎𤋜𥊐𥋫𪸲𬊚𰖥𰖦𰟈𰟉𰟗
蠢	偆惷𡥑𢧋𢧔𢧨𢧬𢧭𢧸𢨎𢨢𢨣𣁤𧅪𧉾𧎌𧐧𧓟𧕷𧕹𰒫
阴	侌阥陰隂霒𠆭𠊺𢉩𣍤𣱙𤽎𨹉𨹩𨻔𨼖𨽙𨽭𩃬𬍖𬯉𮥏
难	難𨿻𩀏𩀙𩀡𩀤𩁘𩁚𩁢𩁣𩁤𩁩𩁪𩁬𩁮𩁲𩁳𪄿𪅀𪇠𪇼
御	吾禦䘖䘘𠉳𠨙𡕺𢓦𢓷𢔞𢔫𢔬𢕜𢕥𢖡𤎇𧗨𧗪𧗻𨝈𫑨𰆍
渊	囦淵渁渆渕灁㴊㶜𠀯𠝃𡆼𣴸𣴺𣵃𣶒𣷨𣷬𣾜𣾬𤀵𪶕𫞘
烟	焑煙菸㷑𠖜𠖣𡇽𡨾𡫈𤇆𤉁𤊗𤎆𤎟𤏎𤏯𤰓𭑗𭴜𰞥𰟒𰟜
熙	凞焈煕熈㷂㷗㷩𤋮𠘑𠘕𤀠𤇐𤇴𤉰𤋮𤎹𤏁𤐤𪷨𬦎𭝨𭰨
策	拺敇笧筞筴箣萗䇿𠞁𠞦𠷽𢄆𣍸𥫪𥮥𥮮𥮵𥳯𫁰𬕕𭁨𰃩
国	囶囻圀國㕵䆐𠩥𠮚𠰧𡆻𡆿𡇅𡇎𡇏𡇕𡈑𢦾𢧌𢧜𢧰𤦂𤦒𭍝
琴	珡琹䥅䥆䦦𠓿𣓵𣕰𤦡𤧂𤩟𤫍𤫒𨨖𨪖𨫹𩰔𪻴𭩿𰡷𰢆𰢇𰢌
祸	旤祻禍䄀𢢸𣄸𣨱𣨷𥙯𥚁𥚍𥚟𥚣𥚽𥛔𧙹𧛂𧜓𨉒𨉵𨊇𫀽𰧽
鼓	皷皼鼔𠡉𡔷𣫊𤈸𤿝𩉨𩉩𩉲𩊉𩌀𩙏𪔎𪔐𪔨𮆟𮮦𰚃𰩩𰶟⿎
宝	宲寚寳寶珤葆靌㻄𠋾𠍙𡧖𡧰𡩧𡪓𡫷𢉔𢉣𢉹𤥖𤥯𤨷𫳽𭔟𮀛
龙	尨竜龍龒㡣䮾𠉒𠊋𢀀𢄫𢅛𥪐𥪑𥪖𥪢𥫆𥫈𦱉𦱸𩔍𩧑𮧻⻯⻰
灵	霛霝靈龗㚑㦭䨩𠳄𡀓𢩙𢩝𤫊𤴤𧈀𧨈𩁻𩂳𩃏𩃞𩄇𩅶𩆕𩆜𩆮𩇃
乱	乿亂釠𠃶𠃹𠃿𠦨𠦸𠧎𠧏𠭟𠮗𡭸𢿢𢿮𢿳𣀑𤔒𤔔𤔦𤔬𤕅𰀟𰠂𰠆𰠉𰠊
爵	爵𠕢𠙘𡬠𡭌𢋺𣝣𣡫𤔸𥥼𥧀𨰜𩰣𩰥𩰦𩰧𩰨𪴦𫨀𬅏𬅖𬅘𬅜𬋷𮫗爵𰪖
网	網罒罓㓁䋄䋞䍏𠔿𠕀𠕃𠕈𡇄𡉮𥾼𦉮𦉯𦉳𦉸𦉽𦉾𦊀𦋟𦌅𮊌𰃧𰃨⽹
迁	拪遷䙲䙴䢬𠨧𠨨𠨩𢍱𢍹𢫥𦦉𦦒𨒟𨒿𨔰𨕞𨗆𨗇𨗢𨗺𨙘𨙙𨙞𫎾𮗀𮟀
罅	鎼鏬㙤䖎𤗑𤗕𤗭𥕕𦉏𦉑𧇍𨄥𨩘𨩞𨩽𨫴𨬲𨬳𨬶𨬷𨭴𨮣𨻲𨽯𩄗𬙓𮈺𰧩𱀸
魅	祙鬽䰨䰪𠃁𢑘𢑙𣷛𣼙𤱮𤲄𥘯𧭵𧱋𩱿𩲀𩲈𩲉𩲐𩲑𩲝𩲿𩳌𩳞𩳟𩳪𩴈𩴎𱆘
炒	槱焣煼㶤㷅𢐨𢐺𤈓𤈗𤈨𤊛𤊝𤌉𤌖𤌽𤑡𤑵𧺩𩰸𩱂𩱈𩱦𫷲𫷴𭴥𰞝𰞞𰟇𰟌𱆏
杀	殺煞閷𠄒𠮁𢁛𢶞𢼡𢼢𢼯𢼴𢼵𢽅𢽆𢽘𢽮𢽯𢽺𢾈𢿔𢿹𣀎𣏂𣪆𣪖𤔮𧤿𨶓𭣱𭯀𰚄
